播放1989专辑的歌	播放@album专辑的歌
播放Alive专辑的歌	播放@album专辑的歌
播放All The Little Lights专辑的歌	播放@album专辑的歌
播放Animal专辑的歌	播放@album专辑的歌
播放Avril Lavigne专辑的歌	播放@album专辑的歌
播放Backstreet's Back专辑的歌	播放@album专辑的歌
播放Body on Me专辑的歌	播放@album专辑的歌
播放Breakaway专辑的歌	播放@album专辑的歌
播放Dance Dance Dance专辑的歌	播放@album专辑的歌
播放Dark Sky Island专辑的歌	播放@album专辑的歌
播放Demi专辑的歌	播放@album专辑的歌
播放Drag Me Down专辑的歌	播放@album专辑的歌
播放Femme Fatale专辑的歌	播放@album专辑的歌
播放Good Time专辑的歌	播放@album专辑的歌
播放GPS密封令专辑的歌	播放@album专辑的歌
播放Hands Of Love专辑的歌	播放@album专辑的歌
播放HONEST专辑的歌	播放@album专辑的歌
播放Honeymoon专辑的歌	播放@album专辑的歌
播放I Cry When I Laugh专辑的歌	播放@album专辑的歌
播放I'm In Love With a Monster专辑的歌	播放@album专辑的歌
播放It's Love专辑的歌	播放@album专辑的歌
播放JJ陆专辑的歌	播放@album专辑的歌
播放Lenka专辑的歌	播放@album专辑的歌
播放Let Go专辑的歌	播放@album专辑的歌
播放Libra专辑的歌	播放@album专辑的歌
播放Listen专辑的歌	播放@album专辑的歌
播放Locked Away专辑的歌	播放@album专辑的歌
播放Made In the A.M.专辑的歌	播放@album专辑的歌
播放Maps专辑的歌	播放@album专辑的歌
播放MC高迪单曲集专辑的歌	播放@album专辑的歌
播放Native专辑的歌	播放@album专辑的歌
播放New Thang专辑的歌	播放@album专辑的歌
播放Oh My My专辑的歌	播放@album专辑的歌
播放Perfect专辑的歌	播放@album专辑的歌
播放PRISM专辑的歌	播放@album专辑的歌
播放Revival专辑的歌	播放@album专辑的歌
播放rice & shine专辑的歌	播放@album专辑的歌
播放Roar专辑的歌	播放@album专辑的歌
播放Sorry专辑的歌	播放@album专辑的歌
播放Stronger专辑的歌	播放@album专辑的歌
播放Take Me When You Go专辑的歌	播放@album专辑的歌
播放The Soulboy Collection专辑的歌	播放@album专辑的歌
播放The Truth About Love专辑的歌	播放@album专辑的歌
播放Today's the Day专辑的歌	播放@album专辑的歌
播放V专辑的歌	播放@album专辑的歌
播放What Makes You Beautiful专辑的歌	播放@album专辑的歌
播放Whistle专辑的歌	播放@album专辑的歌
播放哎呦，不错哦专辑的歌	播放@album专辑的歌
播放爱，不解释专辑的歌	播放@album专辑的歌
播放爱，来的刚好专辑的歌	播放@album专辑的歌
播放爱不解释专辑的歌	播放@album专辑的歌
播放爱的时刻自选辑专辑的歌	播放@album专辑的歌
播放暗影主宰专辑的歌	播放@album专辑的歌
播放不爱最大专辑的歌	播放@album专辑的歌
播放不如吃茶去专辑的歌	播放@album专辑的歌
播放初爱专辑的歌	播放@album专辑的歌
播放辞旧专辑的歌	播放@album专辑的歌
播放当爱已成往事专辑的歌	播放@album专辑的歌
播放等我，再见专辑的歌	播放@album专辑的歌
播放第七感专辑的歌	播放@album专辑的歌
播放电音之王专辑的歌	播放@album专辑的歌
播放范特西专辑的歌	播放@album专辑的歌
播放父亲专辑的歌	播放@album专辑的歌
播放歌手专辑的歌	播放@album专辑的歌
播放涵剧先森专辑的歌	播放@album专辑的歌
播放好安静专辑的歌	播放@album专辑的歌
播放好久不去KTV专辑的歌	播放@album专辑的歌
播放回头爱专辑的歌	播放@album专辑的歌
播放回音Echo专辑的歌	播放@album专辑的歌
播放火花专辑的歌	播放@album专辑的歌
播放火星电台专辑的歌	播放@album专辑的歌
播放机器男友专辑的歌	播放@album专辑的歌
播放建筑师的梦想专辑的歌	播放@album专辑的歌
播放可疑专辑的歌	播放@album专辑的歌
播放跨时代专辑的歌	播放@album专辑的歌
播放李荣浩专辑的歌	播放@album专辑的歌
播放厉害了！我的歌专辑的歌	播放@album专辑的歌
播放每一刻都是崭新的专辑的歌	播放@album专辑的歌
播放明天过后专辑的歌	播放@album专辑的歌
播放模特专辑的歌	播放@album专辑的歌
播放魔杰座专辑的歌	播放@album专辑的歌
播放拿得起放不下专辑的歌	播放@album专辑的歌
播放那个静默的阳光午后专辑的歌	播放@album专辑的歌
播放男朋女友专辑的歌	播放@album专辑的歌
播放你的陈奕迅专辑的歌	播放@album专辑的歌
播放你的名字专辑的歌	播放@album专辑的歌
播放偶像专辑的歌	播放@album专辑的歌
播放徘徊专辑的歌	播放@album专辑的歌
播放七里香专辑的歌	播放@album专辑的歌
播放青春修炼手册专辑的歌	播放@album专辑的歌
播放请你原谅我专辑的歌	播放@album专辑的歌
播放秋故事专辑的歌	播放@album专辑的歌
播放秋夜吟专辑的歌	播放@album专辑的歌
播放燃点专辑的歌	播放@album专辑的歌
播放让世界毁灭专辑的歌	播放@album专辑的歌
播放认了吧专辑的歌	播放@album专辑的歌
播放认真的老去专辑的歌	播放@album专辑的歌
播放如也专辑的歌	播放@album专辑的歌
播放绅士专辑的歌	播放@album专辑的歌
播放神犬小七专辑的歌	播放@album专辑的歌
播放十二新作专辑的歌	播放@album专辑的歌
播放十一月的萧邦专辑的歌	播放@album专辑的歌
播放时光·漫步专辑的歌	播放@album专辑的歌
播放熟悉的味道专辑的歌	播放@album专辑的歌
播放谁叫我们是女人专辑的歌	播放@album专辑的歌
播放她说专辑的歌	播放@album专辑的歌
播放淘气爷孙专辑的歌	播放@album专辑的歌
播放天籁之声专辑的歌	播放@album专辑的歌
播放天生歌姬专辑的歌	播放@album专辑的歌
播放天生骄傲专辑的歌	播放@album专辑的歌
播放完美旅行专辑的歌	播放@album专辑的歌
播放围炉音乐会第1期专辑的歌	播放@album专辑的歌
播放吻别专辑的歌	播放@album专辑的歌
播放我的歌声里专辑的歌	播放@album专辑的歌
播放我的秘密情人专辑的歌	播放@album专辑的歌
播放我管你专辑的歌	播放@album专辑的歌
播放我很忙专辑的歌	播放@album专辑的歌
播放我们专辑的歌	播放@album专辑的歌
播放我们生来就是孤独专辑的歌	播放@album专辑的歌
播放我是星星的孩子专辑的歌	播放@album专辑的歌
播放无法忘记的美专辑的歌	播放@album专辑的歌
播放向天再要500话专辑的歌	播放@album专辑的歌
播放小宇宙专辑的歌	播放@album专辑的歌
播放新地球专辑的歌	播放@album专辑的歌
播放新鲜专辑的歌	播放@album专辑的歌
播放信仰在空中飘扬专辑的歌	播放@album专辑的歌
播放星月神话专辑的歌	播放@album专辑的歌
播放兄与弟专辑的歌	播放@album专辑的歌
播放熊出没之奇幻空间专辑的歌	播放@album专辑的歌
播放旋风少女专辑的歌	播放@album专辑的歌
播放寻雾启示专辑的歌	播放@album专辑的歌
播放一万个舍不得专辑的歌	播放@album专辑的歌
播放依然范特西专辑的歌	播放@album专辑的歌
播放意外专辑的歌	播放@album专辑的歌
播放因你而在专辑的歌	播放@album专辑的歌
播放音乐傲骨专辑的歌	播放@album专辑的歌
播放拥抱你专辑的歌	播放@album专辑的歌
播放宅男专辑的歌	播放@album专辑的歌
播放真善美专辑的歌	播放@album专辑的歌
播放栀子花开 电影原声带专辑的歌	播放@album专辑的歌
播放中国好声音第四季专辑的歌	播放@album专辑的歌
播放庄心妍情歌精选集专辑的歌	播放@album专辑的歌
播放自定义专辑的歌	播放@album专辑的歌
播放最美的拥有专辑的歌	播放@album专辑的歌
播放7妹作曲的歌	播放@music_writer作曲的歌
播放Alan Menken作曲的歌	播放@music_writer作曲的歌
播放Andy Love作曲的歌	播放@music_writer作曲的歌
播放Arthur Hamilton作曲的歌	播放@music_writer作曲的歌
播放B.I作曲的歌	播放@music_writer作曲的歌
播放Ban Hyoung Moon作曲的歌	播放@music_writer作曲的歌
播放Bard作曲的歌	播放@music_writer作曲的歌
播放BEYOND作曲的歌	播放@music_writer作曲的歌
播放Bjorn Ulvaeus、Benny Andersson作曲的歌	播放@music_writer作曲的歌
播放C. Y. Kong作曲的歌	播放@music_writer作曲的歌
播放CHOI JOON YOUNG作曲的歌	播放@music_writer作曲的歌
播放Choice37作曲的歌	播放@music_writer作曲的歌
播放Chow作曲的歌	播放@music_writer作曲的歌
播放Christopher Chak作曲的歌	播放@music_writer作曲的歌
播放Dante Johnson作曲的歌	播放@music_writer作曲的歌
播放Dewen作曲的歌	播放@music_writer作曲的歌
播放Diego Maria Luisa作曲的歌	播放@music_writer作曲的歌
播放DJ Kkaled作曲的歌	播放@music_writer作曲的歌
播放djsunny作曲的歌	播放@music_writer作曲的歌
播放Dr. Moon作曲的歌	播放@music_writer作曲的歌
播放Drew Ryan Scott作曲的歌	播放@music_writer作曲的歌
播放eric kwok作曲的歌	播放@music_writer作曲的歌
播放G-DRAGON作曲的歌	播放@music_writer作曲的歌
播放作曲的歌	播放@music_writer作曲的歌
播放Hush作曲的歌	播放@music_writer作曲的歌
播放李玖哲作曲的歌	播放@music_writer作曲的歌
播放Jeon作曲的歌	播放@music_writer作曲的歌
播放JerryC作曲的歌	播放@music_writer作曲的歌
播放Jobonyjam作曲的歌	播放@music_writer作曲的歌
播放Jordan Kyle作曲的歌	播放@music_writer作曲的歌
播放董基鉴作曲的歌	播放@music_writer作曲的歌
播放Jun Hae Sung作曲的歌	播放@music_writer作曲的歌
播放Jun Young Choi作曲的歌	播放@music_writer作曲的歌
播放Kenix Cheang作曲的歌	播放@music_writer作曲的歌
播放Kenzie作曲的歌	播放@music_writer作曲的歌
播放Kristen Anderson-Lopez作曲的歌	播放@music_writer作曲的歌
播放Maxime Picard作曲的歌	播放@music_writer作曲的歌
播放MC魏小然作曲的歌	播放@music_writer作曲的歌
播放MEYNA CO作曲的歌	播放@music_writer作曲的歌
播放Mike Chan作曲的歌	播放@music_writer作曲的歌
播放P.K作曲的歌	播放@music_writer作曲的歌
播放PSY作曲的歌	播放@music_writer作曲的歌
播放Richard Marx作曲的歌	播放@music_writer作曲的歌
播放Rusell Harris作曲的歌	播放@music_writer作曲的歌
播放T.Currier作曲的歌	播放@music_writer作曲的歌
播放TEDDY作曲的歌	播放@music_writer作曲的歌
播放Thurge作曲的歌	播放@music_writer作曲的歌
播放Turtles作曲的歌	播放@music_writer作曲的歌
播放Various Writers作曲的歌	播放@music_writer作曲的歌
播放Vincent Chow作曲的歌	播放@music_writer作曲的歌
播放Yoo Gun Hyung作曲的歌	播放@music_writer作曲的歌
播放Yoon Il Sang作曲的歌	播放@music_writer作曲的歌
播放zxhmaster作曲的歌	播放@music_writer作曲的歌
播放阿怪作曲的歌	播放@music_writer作曲的歌
播放阿火作曲的歌	播放@music_writer作曲的歌
播放阿鲲作曲的歌	播放@music_writer作曲的歌
播放阿沁作曲的歌	播放@music_writer作曲的歌
播放阿信作曲的歌	播放@music_writer作曲的歌
播放本兮作曲的歌	播放@music_writer作曲的歌
播放边洛作曲的歌	播放@music_writer作曲的歌
播放蔡伯南作曲的歌	播放@music_writer作曲的歌
播放蔡健雅作曲的歌	播放@music_writer作曲的歌
播放蔡政勋作曲的歌	播放@music_writer作曲的歌
播放曹俊鸿作曲的歌	播放@music_writer作曲的歌
播放曹雪芬作曲的歌	播放@music_writer作曲的歌
播放曾缔作曲的歌	播放@music_writer作曲的歌
播放曾轶可作曲的歌	播放@music_writer作曲的歌
播放常石磊作曲的歌	播放@music_writer作曲的歌
播放陈柏圻作曲的歌	播放@music_writer作曲的歌
播放陈大力作曲的歌	播放@music_writer作曲的歌
播放陈德健作曲的歌	播放@music_writer作曲的歌
播放陈迪作曲的歌	播放@music_writer作曲的歌
播放陈光荣作曲的歌	播放@music_writer作曲的歌
播放陈汉隆作曲的歌	播放@music_writer作曲的歌
播放陈佳明作曲的歌	播放@music_writer作曲的歌
播放陈明章作曲的歌	播放@music_writer作曲的歌
播放陈绮贞作曲的歌	播放@music_writer作曲的歌
播放陈珊妮作曲的歌	播放@music_writer作曲的歌
播放陈升作曲的歌	播放@music_writer作曲的歌
播放陈思函作曲的歌	播放@music_writer作曲的歌
播放陈嵩作曲的歌	播放@music_writer作曲的歌
播放陈威全作曲的歌	播放@music_writer作曲的歌
播放陈伟作曲的歌	播放@music_writer作曲的歌
播放陈熙作曲的歌	播放@music_writer作曲的歌
播放陈翔作曲的歌	播放@music_writer作曲的歌
播放陈小霞作曲的歌	播放@music_writer作曲的歌
播放陈秀男作曲的歌	播放@music_writer作曲的歌
播放陈奕迅作曲的歌	播放@music_writer作曲的歌
播放陈颖见作曲的歌	播放@music_writer作曲的歌
播放陈宇任作曲的歌	播放@music_writer作曲的歌
播放程恢弘作曲的歌	播放@music_writer作曲的歌
播放程振兴作曲的歌	播放@music_writer作曲的歌
播放崔健作曲的歌	播放@music_writer作曲的歌
播放崔伟立作曲的歌	播放@music_writer作曲的歌
播放大桥卓弥作曲的歌	播放@music_writer作曲的歌
播放戴佩妮作曲的歌	播放@music_writer作曲的歌
播放刀郎作曲的歌	播放@music_writer作曲的歌
播放邓紫棋作曲的歌	播放@music_writer作曲的歌
播放东郭先生作曲的歌	播放@music_writer作曲的歌
播放东南作曲的歌	播放@music_writer作曲的歌
播放董冬冬作曲的歌	播放@music_writer作曲的歌
播放都智文作曲的歌	播放@music_writer作曲的歌
播放窦鹏作曲的歌	播放@music_writer作曲的歌
播放杜雯媞作曲的歌	播放@music_writer作曲的歌
播放段思思作曲的歌	播放@music_writer作曲的歌
播放凡间精灵作曲的歌	播放@music_writer作曲的歌
播放方大同作曲的歌	播放@music_writer作曲的歌
播放方炯镔作曲的歌	播放@music_writer作曲的歌
播放方文良作曲的歌	播放@music_writer作曲的歌
播放冯正作曲的歌	播放@music_writer作曲的歌
播放高枫作曲的歌	播放@music_writer作曲的歌
播放高进作曲的歌	播放@music_writer作曲的歌
播放高磊作曲的歌	播放@music_writer作曲的歌
播放高晓松作曲的歌	播放@music_writer作曲的歌
播放高阳作曲的歌	播放@music_writer作曲的歌
播放格非作曲的歌	播放@music_writer作曲的歌
播放恭硕良作曲的歌	播放@music_writer作曲的歌
播放谷建芬作曲的歌	播放@music_writer作曲的歌
播放顾嘉辉作曲的歌	播放@music_writer作曲的歌
播放顾沙峰作曲的歌	播放@music_writer作曲的歌
播放顾雄作曲的歌	播放@music_writer作曲的歌
播放关天天作曲的歌	播放@music_writer作曲的歌
播放冠佑作曲的歌	播放@music_writer作曲的歌
播放郭蘅祈作曲的歌	播放@music_writer作曲的歌
播放郭敬明作曲的歌	播放@music_writer作曲的歌
播放郭文贤作曲的歌	播放@music_writer作曲的歌
播放郭晓天作曲的歌	播放@music_writer作曲的歌
播放郭永利作曲的歌	播放@music_writer作曲的歌
播放海鸣威作曲的歌	播放@music_writer作曲的歌
播放韩红作曲的歌	播放@music_writer作曲的歌
播放韩星洲作曲的歌	播放@music_writer作曲的歌
播放好妹妹乐队作曲的歌	播放@music_writer作曲的歌
播放河合奈保子作曲的歌	播放@music_writer作曲的歌
播放洪典作曲的歌	播放@music_writer作曲的歌
播放侯德健作曲的歌	播放@music_writer作曲的歌
播放侯歌作曲的歌	播放@music_writer作曲的歌
播放呼可儿作曲的歌	播放@music_writer作曲的歌
播放胡力作曲的歌	播放@music_writer作曲的歌
播放胡彦斌作曲的歌	播放@music_writer作曲的歌
播放华晨宇作曲的歌	播放@music_writer作曲的歌
播放黄超作曲的歌	播放@music_writer作曲的歌
播放黄大炜作曲的歌	播放@music_writer作曲的歌
播放黄桂兰作曲的歌	播放@music_writer作曲的歌
播放黄国俊作曲的歌	播放@music_writer作曲的歌
播放黄国伦作曲的歌	播放@music_writer作曲的歌
播放黄家驹作曲的歌	播放@music_writer作曲的歌
播放黄庆元作曲的歌	播放@music_writer作曲的歌
播放黄晞睿作曲的歌	播放@music_writer作曲的歌
播放黄义达作曲的歌	播放@music_writer作曲的歌
播放黄征作曲的歌	播放@music_writer作曲的歌
播放黄子韬作曲的歌	播放@music_writer作曲的歌
播放黃霑作曲的歌	播放@music_writer作曲的歌
播放回音哥作曲的歌	播放@music_writer作曲的歌
播放贾斯汀·比伯作曲的歌	播放@music_writer作曲的歌
播放简红作曲的歌	播放@music_writer作曲的歌
播放江志仁作曲的歌	播放@music_writer作曲的歌
播放蒋蒋作曲的歌	播放@music_writer作曲的歌
播放金培达作曲的歌	播放@music_writer作曲的歌
播放金莎作曲的歌	播放@music_writer作曲的歌
播放金志文作曲的歌	播放@music_writer作曲的歌
播放柯肇雷作曲的歌	播放@music_writer作曲的歌
播放浪客秦昊作曲的歌	播放@music_writer作曲的歌
播放老猫作曲的歌	播放@music_writer作曲的歌
播放雷颂德作曲的歌	播放@music_writer作曲的歌
播放冷子夕作曲的歌	播放@music_writer作曲的歌
播放黎沸挥作曲的歌	播放@music_writer作曲的歌
播放李风持作曲的歌	播放@music_writer作曲的歌
播放李昊瀚作曲的歌	播放@music_writer作曲的歌
播放李健作曲的歌	播放@music_writer作曲的歌
播放李俊雄作曲的歌	播放@music_writer作曲的歌
播放李俊佑作曲的歌	播放@music_writer作曲的歌
播放李凯稠作曲的歌	播放@music_writer作曲的歌
播放李泉作曲的歌	播放@music_writer作曲的歌
播放李荣浩作曲的歌	播放@music_writer作曲的歌
播放李姗作曲的歌	播放@music_writer作曲的歌
播放李双飞作曲的歌	播放@music_writer作曲的歌
播放李偲菘作曲的歌	播放@music_writer作曲的歌
播放李彤作曲的歌	播放@music_writer作曲的歌
播放李夏作曲的歌	播放@music_writer作曲的歌
播放李毅杰作曲的歌	播放@music_writer作曲的歌
播放李宇春作曲的歌	播放@music_writer作曲的歌
播放李正帆作曲的歌	播放@music_writer作曲的歌
播放李志作曲的歌	播放@music_writer作曲的歌
播放李志清作曲的歌	播放@music_writer作曲的歌
播放李子恒作曲的歌	播放@music_writer作曲的歌
播放李宗盛作曲的歌	播放@music_writer作曲的歌
播放立川俊之作曲的歌	播放@music_writer作曲的歌
播放励阳作曲的歌	播放@music_writer作曲的歌
播放梁翘柏作曲的歌	播放@music_writer作曲的歌
播放廖伟鹏作曲的歌	播放@music_writer作曲的歌
播放廖伟志作曲的歌	播放@music_writer作曲的歌
播放林华勇作曲的歌	播放@music_writer作曲的歌
播放林家庆作曲的歌	播放@music_writer作曲的歌
播放林俊杰作曲的歌	播放@music_writer作曲的歌
播放林隆璇作曲的歌	播放@music_writer作曲的歌
播放Brenna作曲的歌	播放@music_writer作曲的歌
播放林一峰作曲的歌	播放@music_writer作曲的歌
播放林忆莲作曲的歌	播放@music_writer作曲的歌
播放林子祥作曲的歌	播放@music_writer作曲的歌
播放刘大江作曲的歌	播放@music_writer作曲的歌
播放刘佳作曲的歌	播放@music_writer作曲的歌
播放刘佳 确定作曲的歌	播放@music_writer作曲的歌
播放刘家昌作曲的歌	播放@music_writer作曲的歌
播放刘瑞琦作曲的歌	播放@music_writer作曲的歌
播放刘扬作曲的歌	播放@music_writer作曲的歌
播放刘永辉作曲的歌	播放@music_writer作曲的歌
播放刘之烁作曲的歌	播放@music_writer作曲的歌
播放刘洲作曲的歌	播放@music_writer作曲的歌
播放柳海准作曲的歌	播放@music_writer作曲的歌
播放卢庚戌作曲的歌	播放@music_writer作曲的歌
播放卢小娟作曲的歌	播放@music_writer作曲的歌
播放陆虎作曲的歌	播放@music_writer作曲的歌
播放逯学军作曲的歌	播放@music_writer作曲的歌
播放路勇作曲的歌	播放@music_writer作曲的歌
播放罗俊霖作曲的歌	播放@music_writer作曲的歌
播放马頔作曲的歌	播放@music_writer作曲的歌
播放马干格作曲的歌	播放@music_writer作曲的歌
播放马饲野康二作曲的歌	播放@music_writer作曲的歌
播放马旭东作曲的歌	播放@music_writer作曲的歌
播放蒙古国民歌作曲的歌	播放@music_writer作曲的歌
播放孟文豪作曲的歌	播放@music_writer作曲的歌
播放梦然作曲的歌	播放@music_writer作曲的歌
播放米景作曲的歌	播放@music_writer作曲的歌
播放木村充利作曲的歌	播放@music_writer作曲的歌
播放南风作曲的歌	播放@music_writer作曲的歌
播放南征北战作曲的歌	播放@music_writer作曲的歌
播放倪子冈作曲的歌	播放@music_writer作曲的歌
播放牛奶咖啡作曲的歌	播放@music_writer作曲的歌
播放潘攀作曲的歌	播放@music_writer作曲的歌
播放潘沁珈作曲的歌	播放@music_writer作曲的歌
播放潘玮柏作曲的歌	播放@music_writer作曲的歌
播放潘协庆作曲的歌	播放@music_writer作曲的歌
播放彭佳慧作曲的歌	播放@music_writer作曲的歌
播放彭学斌作曲的歌	播放@music_writer作曲的歌
播放鹏泊作曲的歌	播放@music_writer作曲的歌
播放朴树作曲的歌	播放@music_writer作曲的歌
播放齐一作曲的歌	播放@music_writer作曲的歌
播放祁隆作曲的歌	播放@music_writer作曲的歌
播放千年破晓作曲的歌	播放@music_writer作曲的歌
播放芊芊作曲的歌	播放@music_writer作曲的歌
播放钱雷作曲的歌	播放@music_writer作曲的歌
播放乔任梁作曲的歌	播放@music_writer作曲的歌
播放秦昊作曲的歌	播放@music_writer作曲的歌
播放曲世聪作曲的歌	播放@music_writer作曲的歌
播放曲婉婷作曲的歌	播放@music_writer作曲的歌
播放饶善强作曲的歌	播放@music_writer作曲的歌
播放人工卫星作曲的歌	播放@music_writer作曲的歌
播放任淼作曲的歌	播放@music_writer作曲的歌
播放任贤齐作曲的歌	播放@music_writer作曲的歌
播放三宝作曲的歌	播放@music_writer作曲的歌
播放三木刚作曲的歌	播放@music_writer作曲的歌
播放山野作曲的歌	播放@music_writer作曲的歌
播放胜屿作曲的歌	播放@music_writer作曲的歌
播放石亮/苏朵作曲的歌	播放@music_writer作曲的歌
播放宋秉洋作曲的歌	播放@music_writer作曲的歌
播放宋冬野作曲的歌	播放@music_writer作曲的歌
播放宋世尧作曲的歌	播放@music_writer作曲的歌
播放苏朵作曲的歌	播放@music_writer作曲的歌
播放苏运莹作曲的歌	播放@music_writer作曲的歌
播放孙露作曲的歌	播放@music_writer作曲的歌
播放孙侨志作曲的歌	播放@music_writer作曲的歌
播放孙小丁作曲的歌	播放@music_writer作曲的歌
播放孙嫣然作曲的歌	播放@music_writer作曲的歌
播放孙子涵作曲的歌	播放@music_writer作曲的歌
播放谭旋作曲的歌	播放@music_writer作曲的歌
播放汤尼作曲的歌	播放@music_writer作曲的歌
播放唐汉霄作曲的歌	播放@music_writer作曲的歌
播放唐书琛作曲的歌	播放@music_writer作曲的歌
播放唐湘智作曲的歌	播放@music_writer作曲的歌
播放逃跑计划作曲的歌	播放@music_writer作曲的歌
播放陶昌廷作曲的歌	播放@music_writer作曲的歌
播放陶山作曲的歌	播放@music_writer作曲的歌
播放陶喆作曲的歌	播放@music_writer作曲的歌
播放腾格尔作曲的歌	播放@music_writer作曲的歌
播放汀洋作曲的歌	播放@music_writer作曲的歌
播放涂惠元作曲的歌	播放@music_writer作曲的歌
播放万晨作曲的歌	播放@music_writer作曲的歌
播放汪峰作曲的歌	播放@music_writer作曲的歌
播放汪苏泷作曲的歌	播放@music_writer作曲的歌
播放王备作曲的歌	播放@music_writer作曲的歌
播放王菲作曲的歌	播放@music_writer作曲的歌
播放王杰作曲的歌	播放@music_writer作曲的歌
播放王力宏作曲的歌	播放@music_writer作曲的歌
播放王太利作曲的歌	播放@music_writer作曲的歌
播放王童语作曲的歌	播放@music_writer作曲的歌
播放王晓锋作曲的歌	播放@music_writer作曲的歌
播放王雅君作曲的歌	播放@music_writer作曲的歌
播放王绎龙作曲的歌	播放@music_writer作曲的歌
播放王于升作曲的歌	播放@music_writer作曲的歌
播放王铮亮作曲的歌	播放@music_writer作曲的歌
播放威仔作曲的歌	播放@music_writer作曲的歌
播放魏文超作曲的歌	播放@music_writer作曲的歌
播放温伟杰作曲的歌	播放@music_writer作曲的歌
播放温奕哲作曲的歌	播放@music_writer作曲的歌
播放翁清溪作曲的歌	播放@music_writer作曲的歌
播放翁乙仁作曲的歌	播放@music_writer作曲的歌
播放吴剑泓作曲的歌	播放@music_writer作曲的歌
播放吴克羣作曲的歌	播放@music_writer作曲的歌
播放吴克群作曲的歌	播放@music_writer作曲的歌
播放吴青峰作曲的歌	播放@music_writer作曲的歌
播放伍乐城作曲的歌	播放@music_writer作曲的歌
播放伍思凯作曲的歌	播放@music_writer作曲的歌
播放武部聪志作曲的歌	播放@music_writer作曲的歌
播放西楼作曲的歌	播放@music_writer作曲的歌
播放夏婉安作曲的歌	播放@music_writer作曲的歌
播放萧恒嘉作曲的歌	播放@music_writer作曲的歌
播放萧煌奇作曲的歌	播放@music_writer作曲的歌
播放萧敬腾作曲的歌	播放@music_writer作曲的歌
播放萧全作曲的歌	播放@music_writer作曲的歌
播放小安作曲的歌	播放@music_writer作曲的歌
播放小虫作曲的歌	播放@music_writer作曲的歌
播放小王子作曲的歌	播放@music_writer作曲的歌
播放笑天作曲的歌	播放@music_writer作曲的歌
播放谢霆锋作曲的歌	播放@music_writer作曲的歌
播放熊美玲作曲的歌	播放@music_writer作曲的歌
播放徐光义作曲的歌	播放@music_writer作曲的歌
播放徐佳莹作曲的歌	播放@music_writer作曲的歌
播放徐良作曲的歌	播放@music_writer作曲的歌
播放徐沛东作曲的歌	播放@music_writer作曲的歌
播放徐一鸣作曲的歌	播放@music_writer作曲的歌
播放徐子崴作曲的歌	播放@music_writer作曲的歌
播放许华强作曲的歌	播放@music_writer作曲的歌
播放许嵩作曲的歌	播放@music_writer作曲的歌
播放许巍作曲的歌	播放@music_writer作曲的歌
播放薛永嘉作曲的歌	播放@music_writer作曲的歌
播放薛之谦作曲的歌	播放@music_writer作曲的歌
播放雪无影作曲的歌	播放@music_writer作曲的歌
播放鸦片丹作曲的歌	播放@music_writer作曲的歌
播放颜小健作曲的歌	播放@music_writer作曲的歌
播放阳逸晨作曲的歌	播放@music_writer作曲的歌
播放杨坤作曲的歌	播放@music_writer作曲的歌
播放杨瑞代作曲的歌	播放@music_writer作曲的歌
播放杨振邦作曲的歌	播放@music_writer作曲的歌
播放姚云作曲的歌	播放@music_writer作曲的歌
播放野田洋次郎作曲的歌	播放@music_writer作曲的歌
播放叶良俊作曲的歌	播放@music_writer作曲的歌
播放叶圣涛作曲的歌	播放@music_writer作曲的歌
播放叶晓作曲的歌	播放@music_writer作曲的歌
播放衣睿作曲的歌	播放@music_writer作曲的歌
播放艺洋作曲的歌	播放@music_writer作曲的歌
播放易家扬作曲的歌	播放@music_writer作曲的歌
播放印尼民歌作曲的歌	播放@music_writer作曲的歌
播放印尼民谣作曲的歌	播放@music_writer作曲的歌
播放印子月作曲的歌	播放@music_writer作曲的歌
播放于京乐团作曲的歌	播放@music_writer作曲的歌
播放于萱作曲的歌	播放@music_writer作曲的歌
播放宇珩作曲的歌	播放@music_writer作曲的歌
播放羽泉作曲的歌	播放@music_writer作曲的歌
播放雨宗林作曲的歌	播放@music_writer作曲的歌
播放郁冬作曲的歌	播放@music_writer作曲的歌
播放袁惟仁作曲的歌	播放@music_writer作曲的歌
播放泽日生作曲的歌	播放@music_writer作曲的歌
播放詹宇豪作曲的歌	播放@music_writer作曲的歌
播放张超作曲的歌	播放@music_writer作曲的歌
播放张国荣作曲的歌	播放@music_writer作曲的歌
播放张杰作曲的歌	播放@music_writer作曲的歌
播放张敬轩作曲的歌	播放@music_writer作曲的歌
播放张希作曲的歌	播放@music_writer作曲的歌
播放张悬作曲的歌	播放@music_writer作曲的歌
播放张学友作曲的歌	播放@music_writer作曲的歌
播放张亚东作曲的歌	播放@music_writer作曲的歌
播放张宇作曲的歌	播放@music_writer作曲的歌
播放张震岳作曲的歌	播放@music_writer作曲的歌
播放长刚作曲的歌	播放@music_writer作曲的歌
播放赵佳霖作曲的歌	播放@music_writer作曲的歌
播放赵锴作曲的歌	播放@music_writer作曲的歌
播放赵雷作曲的歌	播放@music_writer作曲的歌
播放赵英俊作曲的歌	播放@music_writer作曲的歌
播放赵兆作曲的歌	播放@music_writer作曲的歌
播放赵照作曲的歌	播放@music_writer作曲的歌
播放郑国锋作曲的歌	播放@music_writer作曲的歌
播放郑建浩作曲的歌	播放@music_writer作曲的歌
播放郑楠作曲的歌	播放@music_writer作曲的歌
播放郑文作曲的歌	播放@music_writer作曲的歌
播放郑智化作曲的歌	播放@music_writer作曲的歌
播放中岛美雪作曲的歌	播放@music_writer作曲的歌
播放钟志刚作曲的歌	播放@music_writer作曲的歌
播放周传雄作曲的歌	播放@music_writer作曲的歌
播放周华健作曲的歌	播放@music_writer作曲的歌
播放周杰伦作曲的歌	播放@music_writer作曲的歌
播放周礼茂作曲的歌	播放@music_writer作曲的歌
播放周耀辉作曲的歌	播放@music_writer作曲的歌
播放周治平作曲的歌	播放@music_writer作曲的歌
播放朱鸽作曲的歌	播放@music_writer作曲的歌
播放砖厂浪人作曲的歌	播放@music_writer作曲的歌
播放左安安作曲的歌	播放@music_writer作曲的歌
播放歌词是凉凉夜色为你思念成河的歌	播放歌词是@lyric的歌
播放歌词是支援为你三生痴狂的歌	播放歌词是@lyric的歌
播放歌词是和我在成都的街头走一走的歌	播放歌词是@lyric的歌
播放歌词是要是能重来我要选李白的歌	播放歌词是@lyric的歌
播放歌词是我要选李白的歌	播放歌词是@lyric的歌
播放歌词是十年之前我不认识你的歌	播放歌词是@lyric的歌
播放歌词是左手右手一个慢动作的歌	播放歌词是@lyric的歌
播放歌词是右手一个慢动作的歌	播放歌词是@lyric的歌
播放歌词是谁在用琵琶弹奏一曲东风破的歌	播放歌词是@lyric的歌
播放歌词是一盏离愁孤单伫立在窗口的歌	播放歌词是@lyric的歌
播放歌词是大王叫我来巡山的歌	播放歌词是@lyric的歌
播放歌词是天青色等烟雨而我在等你的歌	播放歌词是@lyric的歌
播放歌词是在这个风起云涌的战场上的歌	播放歌词是@lyric的歌
播放歌词是逆战逆战来也的歌	播放歌词是@lyric的歌
播放歌词是爱真的需要勇气的歌	播放歌词是@lyric的歌
播放歌词是我听见远方下课钟声响起的歌	播放歌词是@lyric的歌
播放歌词是可惜不是你陪我到最后的歌	播放歌词是@lyric的歌
播放歌词是喜欢你那双眼动人的歌	播放歌词是@lyric的歌
播放歌词是美丽的泡沫虽然一刹花火的歌	播放歌词是@lyric的歌
播放3紫作词的歌	播放@lyric_writer作词的歌
播放7妹作词的歌	播放@lyric_writer作词的歌
播放ArthurHamilton作词的歌	播放@lyric_writer作词的歌
播放BEYOND作词的歌	播放@lyric_writer作词的歌
播放cozy作词的歌	播放@lyric_writer作词的歌
播放DanielBedingfield作词的歌	播放@lyric_writer作词的歌
播放Dewen作词的歌	播放@lyric_writer作词的歌
播放djsunny作词的歌	播放@lyric_writer作词的歌
播放G-DRAGON作词的歌	播放@lyric_writer作词的歌
播放Hush作词的歌	播放@lyric_writer作词的歌
播放kiki作词的歌	播放@lyric_writer作词的歌
播放Mc魏小然作词的歌	播放@lyric_writer作词的歌
播放PSY作词的歌	播放@lyric_writer作词的歌
播放RichardMarx作词的歌	播放@lyric_writer作词的歌
播放RileyLin作词的歌	播放@lyric_writer作词的歌
播放TEDDY作词的歌	播放@lyric_writer作词的歌
播放VariousWriters作词的歌	播放@lyric_writer作词的歌
播放zxhmaster作词的歌	播放@lyric_writer作词的歌
播放阿怪作词的歌	播放@lyric_writer作词的歌
播放阿信作词的歌	播放@lyric_writer作词的歌
播放安立奎作词的歌	播放@lyric_writer作词的歌
播放白金明作词的歌	播放@lyric_writer作词的歌
播放本兮作词的歌	播放@lyric_writer作词的歌
播放蔡伯南作词的歌	播放@lyric_writer作词的歌
播放蔡健雅作词的歌	播放@lyric_writer作词的歌
播放曾轶可作词的歌	播放@lyric_writer作词的歌
播放陈柏圻作词的歌	播放@lyric_writer作词的歌
播放陈奂仁作词的歌	播放@lyric_writer作词的歌
播放陈乐融作词的歌	播放@lyric_writer作词的歌
播放陈绮贞作词的歌	播放@lyric_writer作词的歌
播放陈珊妮作词的歌	播放@lyric_writer作词的歌
播放陈少琪作词的歌	播放@lyric_writer作词的歌
播放陈升作词的歌	播放@lyric_writer作词的歌
播放陈曦作词的歌	播放@lyric_writer作词的歌
播放陈翔作词的歌	播放@lyric_writer作词的歌
播放陈小春作词的歌	播放@lyric_writer作词的歌
播放陈信荣作词的歌	播放@lyric_writer作词的歌
播放陈耀川作词的歌	播放@lyric_writer作词的歌
播放陈奕迅作词的歌	播放@lyric_writer作词的歌
播放陈咏谦作词的歌	播放@lyric_writer作词的歌
播放陈宇任作词的歌	播放@lyric_writer作词的歌
播放陈镇川作词的歌	播放@lyric_writer作词的歌
播放程恢弘作词的歌	播放@lyric_writer作词的歌
播放崔健作词的歌	播放@lyric_writer作词的歌
播放崔恕作词的歌	播放@lyric_writer作词的歌
播放崔惟楷作词的歌	播放@lyric_writer作词的歌
播放代岳东作词的歌	播放@lyric_writer作词的歌
播放戴佩妮作词的歌	播放@lyric_writer作词的歌
播放刀郎作词的歌	播放@lyric_writer作词的歌
播放邓紫棋作词的歌	播放@lyric_writer作词的歌
播放丁丁张作词的歌	播放@lyric_writer作词的歌
播放丁冬作词的歌	播放@lyric_writer作词的歌
播放东郭先生作词的歌	播放@lyric_writer作词的歌
播放窦唯作词的歌	播放@lyric_writer作词的歌
播放段思思作词的歌	播放@lyric_writer作词的歌
播放方大同作词的歌	播放@lyric_writer作词的歌
播放方文山作词的歌	播放@lyric_writer作词的歌
播放冯欣慧作词的歌	播放@lyric_writer作词的歌
播放甘世佳作词的歌	播放@lyric_writer作词的歌
播放高进作词的歌	播放@lyric_writer作词的歌
播放高磊作词的歌	播放@lyric_writer作词的歌
播放高晓松作词的歌	播放@lyric_writer作词的歌
播放高阳作词的歌	播放@lyric_writer作词的歌
播放葛根塔娜作词的歌	播放@lyric_writer作词的歌
播放龚淑均作词的歌	播放@lyric_writer作词的歌
播放顾沙峰作词的歌	播放@lyric_writer作词的歌
播放顾雄作词的歌	播放@lyric_writer作词的歌
播放郭德紫毅作词的歌	播放@lyric_writer作词的歌
播放郭敬明作词的歌	播放@lyric_writer作词的歌
播放海雷作词的歌	播放@lyric_writer作词的歌
播放海鸣威作词的歌	播放@lyric_writer作词的歌
播放韩寒作词的歌	播放@lyric_writer作词的歌
播放韩红作词的歌	播放@lyric_writer作词的歌
播放好妹妹乐队作词的歌	播放@lyric_writer作词的歌
播放何静作词的歌	播放@lyric_writer作词的歌
播放洪诚孝作词的歌	播放@lyric_writer作词的歌
播放洪瑞业作词的歌	播放@lyric_writer作词的歌
播放侯德健作词的歌	播放@lyric_writer作词的歌
播放侯歌作词的歌	播放@lyric_writer作词的歌
播放侯俊光作词的歌	播放@lyric_writer作词的歌
播放胡德清作词的歌	播放@lyric_writer作词的歌
播放胡芳芳作词的歌	播放@lyric_writer作词的歌
播放胡力作词的歌	播放@lyric_writer作词的歌
播放胡小健作词的歌	播放@lyric_writer作词的歌
播放胡彦斌作词的歌	播放@lyric_writer作词的歌
播放黄桂兰作词的歌	播放@lyric_writer作词的歌
播放黄家驹作词的歌	播放@lyric_writer作词的歌
播放黄婷作词的歌	播放@lyric_writer作词的歌
播放黄伟作词的歌	播放@lyric_writer作词的歌
播放黄伟文作词的歌	播放@lyric_writer作词的歌
播放黄沾作词的歌	播放@lyric_writer作词的歌
播放黄志龙作词的歌	播放@lyric_writer作词的歌
播放黄子韬作词的歌	播放@lyric_writer作词的歌
播放黃霑作词的歌	播放@lyric_writer作词的歌
播放回音哥作词的歌	播放@lyric_writer作词的歌
播放纪如璟作词的歌	播放@lyric_writer作词的歌
播放简宁作词的歌	播放@lyric_writer作词的歌
播放蒋蒋作词的歌	播放@lyric_writer作词的歌
播放蒋开鲍作词的歌	播放@lyric_writer作词的歌
播放金莎作词的歌	播放@lyric_writer作词的歌
播放鸠摩罗什作词的歌	播放@lyric_writer作词的歌
播放九把刀作词的歌	播放@lyric_writer作词的歌
播放口袋易百作词的歌	播放@lyric_writer作词的歌
播放筷子兄弟作词的歌	播放@lyric_writer作词的歌
播放赖伟锋作词的歌	播放@lyric_writer作词的歌
播放蓝小邪作词的歌	播放@lyric_writer作词的歌
播放冷子夕作词的歌	播放@lyric_writer作词的歌
播放黎明作词的歌	播放@lyric_writer作词的歌
播放李白作词的歌	播放@lyric_writer作词的歌
播放李焯雄作词的歌	播放@lyric_writer作词的歌
播放李峰作词的歌	播放@lyric_writer作词的歌
播放李格弟作词的歌	播放@lyric_writer作词的歌
播放李昊瀚作词的歌	播放@lyric_writer作词的歌
播放李健作词的歌	播放@lyric_writer作词的歌
播放李俊佑作词的歌	播放@lyric_writer作词的歌
播放李克勤作词的歌	播放@lyric_writer作词的歌
播放李泉作词的歌	播放@lyric_writer作词的歌
播放李荣浩作词的歌	播放@lyric_writer作词的歌
播放李瑞洵作词的歌	播放@lyric_writer作词的歌
播放李夏作词的歌	播放@lyric_writer作词的歌
播放李岩作词的歌	播放@lyric_writer作词的歌
播放李瑜哲作词的歌	播放@lyric_writer作词的歌
播放李宇春作词的歌	播放@lyric_writer作词的歌
播放李志作词的歌	播放@lyric_writer作词的歌
播放李志清作词的歌	播放@lyric_writer作词的歌
播放李子恒作词的歌	播放@lyric_writer作词的歌
播放李宗恩作词的歌	播放@lyric_writer作词的歌
播放李宗盛作词的歌	播放@lyric_writer作词的歌
播放厉曼婷作词的歌	播放@lyric_writer作词的歌
播放励阳作词的歌	播放@lyric_writer作词的歌
播放梁芒作词的歌	播放@lyric_writer作词的歌
播放梁心颐作词的歌	播放@lyric_writer作词的歌
播放廖伟志作词的歌	播放@lyric_writer作词的歌
播放林华勇作词的歌	播放@lyric_writer作词的歌
播放林建良作词的歌	播放@lyric_writer作词的歌
播放林俊杰作词的歌	播放@lyric_writer作词的歌
播放林隆璇作词的歌	播放@lyric_writer作词的歌
播放林秋离作词的歌	播放@lyric_writer作词的歌
播放林若宁作词的歌	播放@lyric_writer作词的歌
播放林文炫作词的歌	播放@lyric_writer作词的歌
播放林夕作词的歌	播放@lyric_writer作词的歌
播放林怡凤作词的歌	播放@lyric_writer作词的歌
播放林振强作词的歌	播放@lyric_writer作词的歌
播放刘畅作词的歌	播放@lyric_writer作词的歌
播放刘德华作词的歌	播放@lyric_writer作词的歌
播放刘家泽作词的歌	播放@lyric_writer作词的歌
播放刘瑞琦作词的歌	播放@lyric_writer作词的歌
播放刘同作词的歌	播放@lyric_writer作词的歌
播放刘新圈作词的歌	播放@lyric_writer作词的歌
播放刘虞瑞作词的歌	播放@lyric_writer作词的歌
播放刘源作词的歌	播放@lyric_writer作词的歌
播放刘卓辉作词的歌	播放@lyric_writer作词的歌
播放卢庚戌作词的歌	播放@lyric_writer作词的歌
播放卢小娟作词的歌	播放@lyric_writer作词的歌
播放陆虎作词的歌	播放@lyric_writer作词的歌
播放路勇作词的歌	播放@lyric_writer作词的歌
播放栾杰作词的歌	播放@lyric_writer作词的歌
播放罗志祥作词的歌	播放@lyric_writer作词的歌
播放吕燕卫作词的歌	播放@lyric_writer作词的歌
播放马頔作词的歌	播放@lyric_writer作词的歌
播放马嵩惟作词的歌	播放@lyric_writer作词的歌
播放马旭东作词的歌	播放@lyric_writer作词的歌
播放毛川作词的歌	播放@lyric_writer作词的歌
播放梦然作词的歌	播放@lyric_writer作词的歌
播放米景作词的歌	播放@lyric_writer作词的歌
播放明明作词的歌	播放@lyric_writer作词的歌
播放南征北战作词的歌	播放@lyric_writer作词的歌
播放潘攀作词的歌	播放@lyric_writer作词的歌
播放潘玮柏作词的歌	播放@lyric_writer作词的歌
播放裴育作词的歌	播放@lyric_writer作词的歌
播放彭学斌作词的歌	播放@lyric_writer作词的歌
播放鹏泊作词的歌	播放@lyric_writer作词的歌
播放朴树作词的歌	播放@lyric_writer作词的歌
播放齐一作词的歌	播放@lyric_writer作词的歌
播放祁隆作词的歌	播放@lyric_writer作词的歌
播放芊芊作词的歌	播放@lyric_writer作词的歌
播放浅紫作词的歌	播放@lyric_writer作词的歌
播放乔任梁作词的歌	播放@lyric_writer作词的歌
播放琼瑶作词的歌	播放@lyric_writer作词的歌
播放曲婉婷作词的歌	播放@lyric_writer作词的歌
播放任淼作词的歌	播放@lyric_writer作词的歌
播放桑爱作词的歌	播放@lyric_writer作词的歌
播放桑堆扎布作词的歌	播放@lyric_writer作词的歌
播放山野作词的歌	播放@lyric_writer作词的歌
播放沈庆作词的歌	播放@lyric_writer作词的歌
播放慎芝作词的歌	播放@lyric_writer作词的歌
播放胜屿作词的歌	播放@lyric_writer作词的歌
播放施人诚作词的歌	播放@lyric_writer作词的歌
播放十方作词的歌	播放@lyric_writer作词的歌
播放十一郎作词的歌	播放@lyric_writer作词的歌
播放双笙作词的歌	播放@lyric_writer作词的歌
播放宋冬野作词的歌	播放@lyric_writer作词的歌
播放宋健彰作词的歌	播放@lyric_writer作词的歌
播放宋小明作词的歌	播放@lyric_writer作词的歌
播放苏朵作词的歌	播放@lyric_writer作词的歌
播放苏运莹作词的歌	播放@lyric_writer作词的歌
播放孙露作词的歌	播放@lyric_writer作词的歌
播放孙小丁作词的歌	播放@lyric_writer作词的歌
播放孙仪作词的歌	播放@lyric_writer作词的歌
播放孙艺作词的歌	播放@lyric_writer作词的歌
播放孙卓然作词的歌	播放@lyric_writer作词的歌
播放孙子涵作词的歌	播放@lyric_writer作词的歌
播放谭旋作词的歌	播放@lyric_writer作词的歌
播放檀东晓作词的歌	播放@lyric_writer作词的歌
播放唐书琛作词的歌	播放@lyric_writer作词的歌
播放唐恬作词的歌	播放@lyric_writer作词的歌
播放唐湘智作词的歌	播放@lyric_writer作词的歌
播放唐映枫作词的歌	播放@lyric_writer作词的歌
播放逃跑计划作词的歌	播放@lyric_writer作词的歌
播放陶喆作词的歌	播放@lyric_writer作词的歌
播放腾云驾雾琉璃仙作词的歌	播放@lyric_writer作词的歌
播放天才作词的歌	播放@lyric_writer作词的歌
播放天乐作词的歌	播放@lyric_writer作词的歌
播放桐华作词的歌	播放@lyric_writer作词的歌
播放童年作词的歌	播放@lyric_writer作词的歌
播放娃娃作词的歌	播放@lyric_writer作词的歌
播放汪峰作词的歌	播放@lyric_writer作词的歌
播放汪苏泷作词的歌	播放@lyric_writer作词的歌
播放王菲作词的歌	播放@lyric_writer作词的歌
播放王海涛作词的歌	播放@lyric_writer作词的歌
播放王杰作词的歌	播放@lyric_writer作词的歌
播放王靖雯作词的歌	播放@lyric_writer作词的歌
播放王力宏作词的歌	播放@lyric_writer作词的歌
播放王平久作词的歌	播放@lyric_writer作词的歌
播放王太利作词的歌	播放@lyric_writer作词的歌
播放王童语作词的歌	播放@lyric_writer作词的歌
播放王武雄作词的歌	播放@lyric_writer作词的歌
播放王雅君作词的歌	播放@lyric_writer作词的歌
播放王绎龙作词的歌	播放@lyric_writer作词的歌
播放王钰娟作词的歌	播放@lyric_writer作词的歌
播放王韵韵作词的歌	播放@lyric_writer作词的歌
播放王紫涵作词的歌	播放@lyric_writer作词的歌
播放威仔作词的歌	播放@lyric_writer作词的歌
播放文雅作词的歌	播放@lyric_writer作词的歌
播放吴克羣作词的歌	播放@lyric_writer作词的歌
播放吴克群作词的歌	播放@lyric_writer作词的歌
播放吴梦知作词的歌	播放@lyric_writer作词的歌
播放吴青峰作词的歌	播放@lyric_writer作词的歌
播放吴亦凡作词的歌	播放@lyric_writer作词的歌
播放吴易纬作词的歌	播放@lyric_writer作词的歌
播放武雄作词的歌	播放@lyric_writer作词的歌
播放夏婉安作词的歌	播放@lyric_writer作词的歌
播放向雪怀作词的歌	播放@lyric_writer作词的歌
播放向月娥作词的歌	播放@lyric_writer作词的歌
播放萧煌奇作词的歌	播放@lyric_writer作词的歌
播放萧敬腾作词的歌	播放@lyric_writer作词的歌
播放萧全作词的歌	播放@lyric_writer作词的歌
播放小S作词的歌	播放@lyric_writer作词的歌
播放小虫作词的歌	播放@lyric_writer作词的歌
播放小寒作词的歌	播放@lyric_writer作词的歌
播放小克作词的歌	播放@lyric_writer作词的歌
播放小美作词的歌	播放@lyric_writer作词的歌
播放笑天作词的歌	播放@lyric_writer作词的歌
播放徐光义作词的歌	播放@lyric_writer作词的歌
播放徐佳莹作词的歌	播放@lyric_writer作词的歌
播放徐良作词的歌	播放@lyric_writer作词的歌
播放徐若风作词的歌	播放@lyric_writer作词的歌
播放徐若瑄作词的歌	播放@lyric_writer作词的歌
播放徐子淳作词的歌	播放@lyric_writer作词的歌
播放许常德作词的歌	播放@lyric_writer作词的歌
播放许嵩作词的歌	播放@lyric_writer作词的歌
播放许巍作词的歌	播放@lyric_writer作词的歌
播放薛永嘉作词的歌	播放@lyric_writer作词的歌
播放薛之谦作词的歌	播放@lyric_writer作词的歌
播放雪无影作词的歌	播放@lyric_writer作词的歌
播放闫琦作词的歌	播放@lyric_writer作词的歌
播放严云农作词的歌	播放@lyric_writer作词的歌
播放颜小健作词的歌	播放@lyric_writer作词的歌
播放杨坤作词的歌	播放@lyric_writer作词的歌
播放杨立德作词的歌	播放@lyric_writer作词的歌
播放杨明学作词的歌	播放@lyric_writer作词的歌
播放杨望作词的歌	播放@lyric_writer作词的歌
播放杨眼眼作词的歌	播放@lyric_writer作词的歌
播放杨宗纬作词的歌	播放@lyric_writer作词的歌
播放姚谦作词的歌	播放@lyric_writer作词的歌
播放姚若龙作词的歌	播放@lyric_writer作词的歌
播放野田洋次郎作词的歌	播放@lyric_writer作词的歌
播放叶铭秋作词的歌	播放@lyric_writer作词的歌
播放艺洋作词的歌	播放@lyric_writer作词的歌
播放易家扬作词的歌	播放@lyric_writer作词的歌
播放尹约作词的歌	播放@lyric_writer作词的歌
播放印子月作词的歌	播放@lyric_writer作词的歌
播放尤雅琪作词的歌	播放@lyric_writer作词的歌
播放于京乐团作词的歌	播放@lyric_writer作词的歌
播放于萱作词的歌	播放@lyric_writer作词的歌
播放于正作词的歌	播放@lyric_writer作词的歌
播放羽泉作词的歌	播放@lyric_writer作词的歌
播放雨天作词的歌	播放@lyric_writer作词的歌
播放雨宗林作词的歌	播放@lyric_writer作词的歌
播放玉镯儿作词的歌	播放@lyric_writer作词的歌
播放郁冬作词的歌	播放@lyric_writer作词的歌
播放袁亮作词的歌	播放@lyric_writer作词的歌
播放袁惟仁作词的歌	播放@lyric_writer作词的歌
播放岳毛作词的歌	播放@lyric_writer作词的歌
播放詹于萱作词的歌	播放@lyric_writer作词的歌
播放张超作词的歌	播放@lyric_writer作词的歌
播放张楚翘作词的歌	播放@lyric_writer作词的歌
播放张敬轩作词的歌	播放@lyric_writer作词的歌
播放张磊作词的歌	播放@lyric_writer作词的歌
播放张靓颖作词的歌	播放@lyric_writer作词的歌
播放张楠作词的歌	播放@lyric_writer作词的歌
播放张维作词的歌	播放@lyric_writer作词的歌
播放张悬作词的歌	播放@lyric_writer作词的歌
播放张悠悠作词的歌	播放@lyric_writer作词的歌
播放张彰作词的歌	播放@lyric_writer作词的歌
播放张震岳作词的歌	播放@lyric_writer作词的歌
播放赵辰龙作词的歌	播放@lyric_writer作词的歌
播放赵锴作词的歌	播放@lyric_writer作词的歌
播放赵雷作词的歌	播放@lyric_writer作词的歌
播放赵英俊作词的歌	播放@lyric_writer作词的歌
播放赵耘颖作词的歌	播放@lyric_writer作词的歌
播放郑国江作词的歌	播放@lyric_writer作词的歌
播放郑智化作词的歌	播放@lyric_writer作词的歌
播放知错作词的歌	播放@lyric_writer作词的歌
播放钟志刚作词的歌	播放@lyric_writer作词的歌
播放周兵作词的歌	播放@lyric_writer作词的歌
播放周华健作词的歌	播放@lyric_writer作词的歌
播放周杰伦作词的歌	播放@lyric_writer作词的歌
播放周洁颖作词的歌	播放@lyric_writer作词的歌
播放周礼茂作词的歌	播放@lyric_writer作词的歌
播放周亚岚作词的歌	播放@lyric_writer作词的歌
播放周耀辉作词的歌	播放@lyric_writer作词的歌
播放周治平作词的歌	播放@lyric_writer作词的歌
播放朱鸽作词的歌	播放@lyric_writer作词的歌
播放朱婧汐作词的歌	播放@lyric_writer作词的歌
播放朱其民作词的歌	播放@lyric_writer作词的歌
播放祝峰作词的歌	播放@lyric_writer作词的歌
播放庄奴作词的歌	播放@lyric_writer作词的歌
播放﻿薛之谦的歌	播放@singer的歌
播放周杰伦的歌	播放@singer的歌
播放BIGBANG的歌	播放@singer的歌
播放陈奕迅的歌	播放@singer的歌
播放林俊杰的歌	播放@singer的歌
播放Alan Walker的歌	播放@singer的歌
播放艾伦·沃克的歌	播放@singer的歌
播放李荣浩的歌	播放@singer的歌
播放TFBOYS的歌	播放@singer的歌
播放Maroon 5的歌	播放@singer的歌
播放魔力红乐团的歌	播放@singer的歌
播放许嵩的歌	播放@singer的歌
播放邓紫棋的歌	播放@singer的歌
播放张杰的歌	播放@singer的歌
播放鹿晗的歌	播放@singer的歌
播放庄心妍的歌	播放@singer的歌
播放杨宗纬的歌	播放@singer的歌
播放Justin Bieber的歌	播放@singer的歌
播放贾斯汀·比伯的歌	播放@singer的歌
播放张碧晨的歌	播放@singer的歌
播放华晨宇的歌	播放@singer的歌
播放张学友的歌	播放@singer的歌
播放田馥甄的歌	播放@singer的歌
播放RADWIMPS的歌	播放@singer的歌
播放萧敬腾的歌	播放@singer的歌
播放那英的歌	播放@singer的歌
播放王力宏的歌	播放@singer的歌
播放张靓颖的歌	播放@singer的歌
播放吴亦凡的歌	播放@singer的歌
播放BEYOND的歌	播放@singer的歌
播放林宥嘉的歌	播放@singer的歌
播放南征北战的歌	播放@singer的歌
播放汪苏泷的歌	播放@singer的歌
播放G-DRAGON的歌	播放@singer的歌
播放权志龙的歌	播放@singer的歌
播放苏打绿的歌	播放@singer的歌
播放朴树的歌	播放@singer的歌
播放王菲的歌	播放@singer的歌
播放筷子兄弟的歌	播放@singer的歌
播放MC天佑的歌	播放@singer的歌
播放MC魏小然的歌	播放@singer的歌
播放金志文的歌	播放@singer的歌
播放孙子涵的歌	播放@singer的歌
播放A-Lin的歌	播放@singer的歌
播放许巍的歌	播放@singer的歌
播放宋冬野的歌	播放@singer的歌
播放张惠妹的歌	播放@singer的歌
播放周传雄的歌	播放@singer的歌
播放张信哲的歌	播放@singer的歌
播放杨洋的歌	播放@singer的歌
播放徐良的歌	播放@singer的歌
播放陈小春的歌	播放@singer的歌
播放曲婉婷的歌	播放@singer的歌
播放鹏泊的歌	播放@singer的歌
播放孙燕姿的歌	播放@singer的歌
播放Wiz Khalifa的歌	播放@singer的歌
播放维兹·卡利法的歌	播放@singer的歌
播放张宇的歌	播放@singer的歌
播放葛林的歌	播放@singer的歌
播放莫文蔚的歌	播放@singer的歌
播放张磊的歌	播放@singer的歌
播放Jam的歌	播放@singer的歌
播放牛奶咖啡的歌	播放@singer的歌
播放汪峰的歌	播放@singer的歌
播放Charlie Puth的歌	播放@singer的歌
播放查理·普斯的歌	播放@singer的歌
播放本兮的歌	播放@singer的歌
播放胡夏的歌	播放@singer的歌
播放马旭东的歌	播放@singer的歌
播放威仔的歌	播放@singer的歌
播放李易峰的歌	播放@singer的歌
播放雨宗林的歌	播放@singer的歌
播放郭静的歌	播放@singer的歌
播放李宇春的歌	播放@singer的歌
播放张韶涵的歌	播放@singer的歌
播放萌萌哒天团的歌	播放@singer的歌
播放Fall Out Boy的歌	播放@singer的歌
播放打倒男孩的歌	播放@singer的歌
播放Rihanna的歌	播放@singer的歌
播放蕾哈娜的歌	播放@singer的歌
播放The Chainsmokers的歌	播放@singer的歌
播放烟民二人组的歌	播放@singer的歌
播放夏婉安的歌	播放@singer的歌
播放周二珂的歌	播放@singer的歌
播放Tez Cadey的歌	播放@singer的歌
播放Eminem的歌	播放@singer的歌
播放艾米纳姆的歌	播放@singer的歌
播放张敬轩的歌	播放@singer的歌
播放齐一的歌	播放@singer的歌
播放韩安旭的歌	播放@singer的歌
播放李圣杰的歌	播放@singer的歌
播放张赫宣的歌	播放@singer的歌
播放防弹少年团的歌	播放@singer的歌
播放刘瑞琦的歌	播放@singer的歌
播放Adele的歌	播放@singer的歌
播放阿黛尔的歌	播放@singer的歌
播放双笙的歌	播放@singer的歌
播放逃跑计划的歌	播放@singer的歌
播放BLACKPINK的歌	播放@singer的歌
播放易烊千玺的歌	播放@singer的歌
播放Owl City的歌	播放@singer的歌
播放猫头鹰之城的歌	播放@singer的歌
播放谭晶的歌	播放@singer的歌
播放陈翔的歌	播放@singer的歌
播放刘德华的歌	播放@singer的歌
播放One Direction的歌	播放@singer的歌
播放单向组合的歌	播放@singer的歌
播放蔡健雅的歌	播放@singer的歌
播放范玮琪的歌	播放@singer的歌
播放徐佳莹的歌	播放@singer的歌
播放金南玲的歌	播放@singer的歌
播放李克勤的歌	播放@singer的歌
播放齐晨的歌	播放@singer的歌
播放乔任梁的歌	播放@singer的歌
播放7妹的歌	播放@singer的歌
播放王俊凯的歌	播放@singer的歌
播放Avril Lavigne的歌	播放@singer的歌
播放艾薇儿·拉维尼的歌	播放@singer的歌
播放艾薇儿的歌	播放@singer的歌
播放蔡依林的歌	播放@singer的歌
播放王杰的歌	播放@singer的歌
播放Bruno Mars的歌	播放@singer的歌
播放布鲁诺·马尔斯的歌	播放@singer的歌
播放谭咏麟的歌	播放@singer的歌
播放BY2的歌	播放@singer的歌
播放金莎的歌	播放@singer的歌
播放Taylor Swift的歌	播放@singer的歌
播放泰勒·斯威夫特的歌	播放@singer的歌
播放泰勒的歌	播放@singer的歌
播放孙露的歌	播放@singer的歌
播放梦然的歌	播放@singer的歌
播放陶喆的歌	播放@singer的歌
播放好妹妹乐队的歌	播放@singer的歌
播放Flo Rida的歌	播放@singer的歌
播放佛罗·里达的歌	播放@singer的歌
播放Kelly Clarkson的歌	播放@singer的歌
播放凯丽·克莱森的歌	播放@singer的歌
播放萧亚轩的歌	播放@singer的歌
播放潘玮柏的歌	播放@singer的歌
播放胡彦斌的歌	播放@singer的歌
播放梁静茹的歌	播放@singer的歌
播放魏新雨的歌	播放@singer的歌
播放刘涛的歌	播放@singer的歌
播放李健的歌	播放@singer的歌
播放方大同的歌	播放@singer的歌
播放郁可唯的歌	播放@singer的歌
播放古巨基的歌	播放@singer的歌
播放杨烁的歌	播放@singer的歌
播放李行亮的歌	播放@singer的歌
播放Carly Rae Jepsen的歌	播放@singer的歌
播放卡莉·蕾·吉普森的歌	播放@singer的歌
播放陈慧娴的歌	播放@singer的歌
播放Lenka的歌	播放@singer的歌
播放蕾恩卡·克莉帕克的歌	播放@singer的歌
播放徐歌阳的歌	播放@singer的歌
播放信乐团的歌	播放@singer的歌
播放太阳的歌	播放@singer的歌
播放张国荣的歌	播放@singer的歌
播放魏晨的歌	播放@singer的歌
播放简弘亦的歌	播放@singer的歌
播放Katy Perry的歌	播放@singer的歌
播放凯蒂·佩瑞的歌	播放@singer的歌
播放阿杜的歌	播放@singer的歌
播放The Weeknd的歌	播放@singer的歌
播放威肯的歌	播放@singer的歌
播放马頔的歌	播放@singer的歌
播放OneRepublic的歌	播放@singer的歌
播放一体共和乐队的歌	播放@singer的歌
播放TheFatRat的歌	播放@singer的歌
播放胖鼠乐队的歌	播放@singer的歌
播放陈势安的歌	播放@singer的歌
播放Tobu的歌	播放@singer的歌
播放7obu的歌	播放@singer的歌
播放韩红的歌	播放@singer的歌
播放降央卓玛的歌	播放@singer的歌
播放水木年华的歌	播放@singer的歌
播放曾轶可的歌	播放@singer的歌
播放何洁的歌	播放@singer的歌
播放容祖儿的歌	播放@singer的歌
播放赵骏的歌	播放@singer的歌
播放杨千嬅的歌	播放@singer的歌
播放王童语的歌	播放@singer的歌
播放羽泉的歌	播放@singer的歌
播放罗志祥的歌	播放@singer的歌
播放胡歌的歌	播放@singer的歌
播放印子月的歌	播放@singer的歌
播放陈学冬的歌	播放@singer的歌
播放贾乃亮的歌	播放@singer的歌
播放许一鸣的歌	播放@singer的歌
播放邓丽君的歌	播放@singer的歌
播放谢安琪的歌	播放@singer的歌
播放杨坤的歌	播放@singer的歌
播放刘思涵的歌	播放@singer的歌
播放蒋蒋的歌	播放@singer的歌
播放刀郎的歌	播放@singer的歌
播放蒋敦豪的歌	播放@singer的歌
播放EXO的歌	播放@singer的歌
播放汪晨蕊的歌	播放@singer的歌
播放高进的歌	播放@singer的歌
播放姚贝娜的歌	播放@singer的歌
播放励阳的歌	播放@singer的歌
播放冷漠的歌	播放@singer的歌
播放iKON的歌	播放@singer的歌
播放黄子韬的歌	播放@singer的歌
播放Gala的歌	播放@singer的歌
播放梁朝伟的歌	播放@singer的歌
播放周柏豪的歌	播放@singer的歌
播放GD X TAEYANG的歌	播放@singer的歌
播放南拳妈妈的歌	播放@singer的歌
播放回音哥的歌	播放@singer的歌
播放Westlife的歌	播放@singer的歌
播放西城男孩的歌	播放@singer的歌
播放萧全的歌	播放@singer的歌
播放封茗囧菌的歌	播放@singer的歌
播放杨丞琳的歌	播放@singer的歌
播放白静晨的歌	播放@singer的歌
播放Ellie Goulding的歌	播放@singer的歌
播放艾丽·高登的歌	播放@singer的歌
播放PSY的歌	播放@singer的歌
播放朴载相的歌	播放@singer的歌
播放海鸣威的歌	播放@singer的歌
播放颜小健的歌	播放@singer的歌
播放JC的歌	播放@singer的歌
播放Fifth Harmony的歌	播放@singer的歌
播放五美的歌	播放@singer的歌
播放泫雅的歌	播放@singer的歌
播放Ariana Grande的歌	播放@singer的歌
播放爱莉安娜·格兰德的歌	播放@singer的歌
播放林忆莲的歌	播放@singer的歌
播放王绎龙的歌	播放@singer的歌
播放赵雷的歌	播放@singer的歌
播放Sia的歌	播放@singer的歌
播放希雅的歌	播放@singer的歌
播放黄勇的歌	播放@singer的歌
播放乌兰图雅的歌	播放@singer的歌
播放王铮亮的歌	播放@singer的歌
播放Britney Spears的歌	播放@singer的歌
播放布兰妮·斯皮尔斯的歌	播放@singer的歌
播放小虎队的歌	播放@singer的歌
播放Shakira的歌	播放@singer的歌
播放夏奇拉的歌	播放@singer的歌
播放GD&T.O.P的歌	播放@singer的歌
播放权志龙&崔胜铉的歌	播放@singer的歌
播放刘惜君的歌	播放@singer的歌
播放龙梅子的歌	播放@singer的歌
播放Coldplay的歌	播放@singer的歌
播放酷玩乐队的歌	播放@singer的歌
播放郑伊健的歌	播放@singer的歌
播放罗大佑的歌	播放@singer的歌
播放2NE1的歌	播放@singer的歌
播放Christopher的歌	播放@singer的歌
播放克里斯托弗的歌	播放@singer的歌
播放银临的歌	播放@singer的歌
播放苏勒亚其其格的歌	播放@singer的歌
播放Asher Book的歌	播放@singer的歌
播放阿什·布克的歌	播放@singer的歌
播放姜鹏的歌	播放@singer的歌
播放MC蓝弟的歌	播放@singer的歌
播放王若琳的歌	播放@singer的歌
播放贰佰的歌	播放@singer的歌
播放郑秀文的歌	播放@singer的歌
播放黎明的歌	播放@singer的歌
播放花粥的歌	播放@singer的歌
播放Timbaland的歌	播放@singer的歌
播放提姆巴兰的歌	播放@singer的歌
播放徐誉滕的歌	播放@singer的歌
播放兮雅的歌	播放@singer的歌
播放张一山的歌	播放@singer的歌
播放赖伟锋的歌	播放@singer的歌
播放T.R.Y的歌	播放@singer的歌
播放星弟的歌	播放@singer的歌
播放陈百强的歌	播放@singer的歌
播放吴雨霏的歌	播放@singer的歌
播放河图的歌	播放@singer的歌
播放陈慧琳的歌	播放@singer的歌
播放任贤齐的歌	播放@singer的歌
播放MC画师的歌	播放@singer的歌
播放六哲的歌	播放@singer的歌
播放孝琳的歌	播放@singer的歌
播放单色凌的歌	播放@singer的歌
播放陈雅森的歌	播放@singer的歌
播放刘珂矣的歌	播放@singer的歌
播放Backstreet Boys的歌	播放@singer的歌
播放后街男孩的歌	播放@singer的歌
播放澤野弘之的歌	播放@singer的歌
播放Shawn Mendes的歌	播放@singer的歌
播放肖恩·曼德斯的歌	播放@singer的歌
播放Charli XCX的歌	播放@singer的歌
播放查莉 XCX的歌	播放@singer的歌
播放Trouble Maker的歌	播放@singer的歌
播放K.Will的歌	播放@singer的歌
播放高胜美的歌	播放@singer的歌
播放姜育恒的歌	播放@singer的歌
播放郑智化的歌	播放@singer的歌
播放老狼的歌	播放@singer的歌
播放郝琪力的歌	播放@singer的歌
播放万万小宇宙的歌	播放@singer的歌
播放马博的歌	播放@singer的歌
播放青蛙乐队的歌	播放@singer的歌
播放李佳薇的歌	播放@singer的歌
播放Frankmusik的歌	播放@singer的歌
播放文森特·弗兰克的歌	播放@singer的歌
播放邱永传的歌	播放@singer的歌
播放曾沛慈的歌	播放@singer的歌
播放吉克隽逸的歌	播放@singer的歌
播放MC楚新的歌	播放@singer的歌
播放Armin Van Buuren的歌	播放@singer的歌
播放阿曼·凡·布伦的歌	播放@singer的歌
播放Major Lazer的歌	播放@singer的歌
播放拉扎尔少校的歌	播放@singer的歌
播放侧田的歌	播放@singer的歌
播放龙井说唱的歌	播放@singer的歌
播放张智霖的歌	播放@singer的歌
播放冰冰超人的歌	播放@singer的歌
播放带泪的鱼的歌	播放@singer的歌
播放Meghan Trainor的歌	播放@singer的歌
播放梅根·特瑞娜的歌	播放@singer的歌
播放灿烈的歌	播放@singer的歌
播放Miley Cyrus的歌	播放@singer的歌
播放麦莉·赛勒斯的歌	播放@singer的歌
播放陈一发的歌	播放@singer的歌
播放林峯的歌	播放@singer的歌
播放陈乔恩的歌	播放@singer的歌
播放严艺丹的歌	播放@singer的歌
播放4MINUTE的歌	播放@singer的歌
播放Twins的歌	播放@singer的歌
播放金海心的歌	播放@singer的歌
播放Remady的歌	播放@singer的歌
播放瑞马谛的歌	播放@singer的歌
播放Demi Lovato的歌	播放@singer的歌
播放黛米·洛瓦托的歌	播放@singer的歌
播放任素汐的歌	播放@singer的歌
播放Davichi的歌	播放@singer的歌
播放樊凡的歌	播放@singer的歌
播放Ailee的歌	播放@singer的歌
播放P!NK的歌	播放@singer的歌
播放粉红佳人的歌	播放@singer的歌
播放Daniel Powter的歌	播放@singer的歌
播放丹尼尔·帕德的歌	播放@singer的歌
播放王笑文的歌	播放@singer的歌
播放Two Steps From Hell的歌	播放@singer的歌
播放两步逃离地狱的歌	播放@singer的歌
播放Chris Medina的歌	播放@singer的歌
播放克里斯·梅迪纳的歌	播放@singer的歌
播放TJR的歌	播放@singer的歌
播放TJR组合的歌	播放@singer的歌
播放祁隆的歌	播放@singer的歌
播放卓依婷的歌	播放@singer的歌
播放李宗盛的歌	播放@singer的歌
播放Steerner的歌	播放@singer的歌
播放斯蒂尔的歌	播放@singer的歌
播放阿木子心的歌	播放@singer的歌
播放Far East Movement的歌	播放@singer的歌
播放远东韵律的歌	播放@singer的歌
播放The Downtown Fiction的歌	播放@singer的歌
播放城市小说乐队的歌	播放@singer的歌
播放少女时代的歌	播放@singer的歌
播放刘若英的歌	播放@singer的歌
播放陈楚生的歌	播放@singer的歌
播放飞儿乐团的歌	播放@singer的歌
播放Git Fresh的歌	播放@singer的歌
播放戴荃的歌	播放@singer的歌
播放MC另类鹏的歌	播放@singer的歌
播放陈柏宇的歌	播放@singer的歌
播放Linkin Park的歌	播放@singer的歌
播放林肯公园的歌	播放@singer的歌
播放小沈阳的歌	播放@singer的歌
播放邓超的歌	播放@singer的歌
播放艺涛的歌	播放@singer的歌
播放凤凰传奇的歌	播放@singer的歌
播放庾澄庆的歌	播放@singer的歌
播放戚薇的歌	播放@singer的歌
播放格子兮的歌	播放@singer的歌
播放光良的歌	播放@singer的歌
播放大张伟的歌	播放@singer的歌
播放童可可的歌	播放@singer的歌
播放张芸京的歌	播放@singer的歌
播放后弦的歌	播放@singer的歌
播放谭维维的歌	播放@singer的歌
播放李玉刚的歌	播放@singer的歌
播放任然的歌	播放@singer的歌
播放温岚的歌	播放@singer的歌
播放周深的歌	播放@singer的歌
播放彭佳慧的歌	播放@singer的歌
播放宋孟君的歌	播放@singer的歌
播放郑源的歌	播放@singer的歌
播放王源的歌	播放@singer的歌
播放Children's Christmas Favorites的歌	播放@singer的歌
播放Michael Jackson的歌	播放@singer的歌
播放迈克尔·杰克逊的歌	播放@singer的歌
播放黄龄的歌	播放@singer的歌
播放DJ小可的歌	播放@singer的歌
播放Calvin Harris的歌	播放@singer的歌
播放卡尔文·哈里斯的歌	播放@singer的歌
播放金玟岐的歌	播放@singer的歌
播放Mariah Carey的歌	播放@singer的歌
播放玛丽亚·凯莉的歌	播放@singer的歌
播放Groove Coverage的歌	播放@singer的歌
播放舞动精灵乐团的歌	播放@singer的歌
播放小贱的歌	播放@singer的歌
播放谭冰尧的歌	播放@singer的歌
播放林志炫的歌	播放@singer的歌
播放吴克群的歌	播放@singer的歌
播放虞姬的歌	播放@singer的歌
播放梁咏琪的歌	播放@singer的歌
播放陈瑞的歌	播放@singer的歌
播放许茹芸的歌	播放@singer的歌
播放Jessie J的歌	播放@singer的歌
播放洁西·J的歌	播放@singer的歌
播放Pitbull的歌	播放@singer的歌
播放皮普保罗的歌	播放@singer的歌
播放权赫的歌	播放@singer的歌
播放云菲菲的歌	播放@singer的歌
播放MC张凯的歌	播放@singer的歌
播放唐古的歌	播放@singer的歌
播放安苏羽的歌	播放@singer的歌
播放DBboys组合的歌	播放@singer的歌
播放李代沫的歌	播放@singer的歌
播放EXID的歌	播放@singer的歌
播放张艺兴的歌	播放@singer的歌
播放T-ara的歌	播放@singer的歌
播放Colbie Caillat的歌	播放@singer的歌
播放蔻比·凯蕾的歌	播放@singer的歌
播放陈鸿宇的歌	播放@singer的歌
播放戴佩妮的歌	播放@singer的歌
播放Ke$ha的歌	播放@singer的歌
播放钱妞的歌	播放@singer的歌
播放尹美莱的歌	播放@singer的歌
播放马天宇的歌	播放@singer的歌
播放Akon的歌	播放@singer的歌
播放阿肯的歌	播放@singer的歌
播放高安的歌	播放@singer的歌
播放小右的歌	播放@singer的歌
播放Imagine Dragons的歌	播放@singer的歌
播放梦龙的歌	播放@singer的歌
播放至上励合的歌	播放@singer的歌
播放许飞的歌	播放@singer的歌
播放卫兰的歌	播放@singer的歌
播放杨炅翰的歌	播放@singer的歌
播放王心凌的歌	播放@singer的歌
播放金贵晟的歌	播放@singer的歌
播放程响的歌	播放@singer的歌
播放六月的歌	播放@singer的歌
播放Soler的歌	播放@singer的歌
播放迪克牛仔的歌	播放@singer的歌
播放张小七的歌	播放@singer的歌
播放IU的歌	播放@singer的歌
播放Troye Sivan的歌	播放@singer的歌
播放特洛伊·希文的歌	播放@singer的歌
播放孙楠的歌	播放@singer的歌
播放陈伟霆的歌	播放@singer的歌
播放Beyoncé的歌	播放@singer的歌
播放碧昂丝的歌	播放@singer的歌
播放关喆的歌	播放@singer的歌
播放齐秦的歌	播放@singer的歌
播放AOA的歌	播放@singer的歌
播放MC九局的歌	播放@singer的歌
播放GARNiDELiA的歌	播放@singer的歌
播放Mark Ronson的歌	播放@singer的歌
播放马克·荣森的歌	播放@singer的歌
播放Chen的歌	播放@singer的歌
播放李琦的歌	播放@singer的歌
播放Zedd的歌	播放@singer的歌
播放捷德的歌	播放@singer的歌
播放张雨生的歌	播放@singer的歌
播放范晓萱的歌	播放@singer的歌
播放周笔畅的歌	播放@singer的歌
播放WINNER的歌	播放@singer的歌
播放排骨教主的歌	播放@singer的歌
播放少司命的歌	播放@singer的歌
播放蒙面哥的歌	播放@singer的歌
播放低调组合的歌	播放@singer的歌
播放李翊君的歌	播放@singer的歌
播放Jack Ü的歌	播放@singer的歌
播放杰克·Ü的歌	播放@singer的歌
播放许佳慧的歌	播放@singer的歌
播放Twenty One Pilots的歌	播放@singer的歌
播放二十一名飞行员的歌	播放@singer的歌
播放姜玉阳的歌	播放@singer的歌
播放Usher的歌	播放@singer的歌
播放亚瑟小子的歌	播放@singer的歌
播放Otto Knows的歌	播放@singer的歌
播放陈都灵的歌	播放@singer的歌
播放Avicii的歌	播放@singer的歌
播放Black Eyed Peas的歌	播放@singer的歌
播放黑眼豆豆的歌	播放@singer的歌
播放Laszlo的歌	播放@singer的歌
播放拉斯洛的歌	播放@singer的歌
播放S.H.E的歌	播放@singer的歌
播放Rudimental的歌	播放@singer的歌
播放根基乐团的歌	播放@singer的歌
播放CNBLUE的歌	播放@singer的歌
播放Ramin Djawadi的歌	播放@singer的歌
播放拉民·贾瓦迪的歌	播放@singer的歌
播放弦子的歌	播放@singer的歌
播放阿里郎的歌	播放@singer的歌
播放David Guetta的歌	播放@singer的歌
播放大卫·库塔的歌	播放@singer的歌
播放安东阳的歌	播放@singer的歌
播放张思思的歌	播放@singer的歌
播放Mi2的歌	播放@singer的歌
播放MC阿哲的歌	播放@singer的歌
播放费玉清的歌	播放@singer的歌
播放许美静的歌	播放@singer的歌
播放Paula DeAnda的歌	播放@singer的歌
播放宝拉·狄安妲的歌	播放@singer的歌
播放薛凯琪的歌	播放@singer的歌
播放北嶋彻的歌	播放@singer的歌
播放小曲儿的歌	播放@singer的歌
播放刘明湘的歌	播放@singer的歌
播放李晓杰的歌	播放@singer的歌
播放伍佰的歌	播放@singer的歌
播放梅艳芳的歌	播放@singer的歌
播放杨幂的歌	播放@singer的歌
播放Adam Lambert的歌	播放@singer的歌
播放亚当·兰伯特的歌	播放@singer的歌
播放MINO的歌	播放@singer的歌
播放宋旻浩的歌	播放@singer的歌
播放门丽的歌	播放@singer的歌
播放Nightwish的歌	播放@singer的歌
播放夜愿的歌	播放@singer的歌
播放脸红的思春期的歌	播放@singer的歌
播放蔡淳佳的歌	播放@singer的歌
播放草蜢的歌	播放@singer的歌
播放黄小琥的歌	播放@singer的歌
播放赵照的歌	播放@singer的歌
播放霍建华的歌	播放@singer的歌
播放单良的歌	播放@singer的歌
播放Shayne Ward的歌	播放@singer的歌
播放尚恩·沃德的歌	播放@singer的歌
播放郑中基的歌	播放@singer的歌
播放孟庭苇的歌	播放@singer的歌
播放包师语的歌	播放@singer的歌
播放Selena Gomez的歌	播放@singer的歌
播放赛琳娜·戈麦斯的歌	播放@singer的歌
播放何炅的歌	播放@singer的歌
播放Clean Bandit的歌	播放@singer的歌
播放清洁盗贼的歌	播放@singer的歌
播放Rixton的歌	播放@singer的歌
播放里克斯顿乐队的歌	播放@singer的歌
播放Fais的歌	播放@singer的歌
播放白智英的歌	播放@singer的歌
播放Jewel的歌	播放@singer的歌
播放珠儿的歌	播放@singer的歌
播放Zeds Dead的歌	播放@singer的歌
播放谢霆锋的歌	播放@singer的歌
播放GOT7的歌	播放@singer的歌
播放周华健的歌	播放@singer的歌
播放M2M的歌	播放@singer的歌
播放窈窕美眉的歌	播放@singer的歌
播放Justin Timberlake的歌	播放@singer的歌
播放贾斯汀·汀布莱克的歌	播放@singer的歌
播放DJ OKAWARI的歌	播放@singer的歌
播放VAVA的歌	播放@singer的歌
播放李志的歌	播放@singer的歌
播放小可的歌	播放@singer的歌
播放吴若希的歌	播放@singer的歌
播放陈洁仪的歌	播放@singer的歌
播放糖糖的歌	播放@singer的歌
播放Michael Learns To Rock的歌	播放@singer的歌
播放迈克学摇滚的歌	播放@singer的歌
播放Sarah Connor的歌	播放@singer的歌
播放莎拉·蔻娜的歌	播放@singer的歌
播放Jason Mraz的歌	播放@singer的歌
播放杰森·玛耶兹的歌	播放@singer的歌
播放五月天的歌	播放@singer的歌
播放苏芮的歌	播放@singer的歌
播放黄渤的歌	播放@singer的歌
播放王思远的歌	播放@singer的歌
播放吴奇隆的歌	播放@singer的歌
播放Tiger JK的歌	播放@singer的歌
播放杜雯媞的歌	播放@singer的歌
播放MC梦的歌	播放@singer的歌
播放屠洪刚的歌	播放@singer的歌
播放王媛渊的歌	播放@singer的歌
播放玖月奇迹的歌	播放@singer的歌
播放沙宝亮的歌	播放@singer的歌
播放成龙的歌	播放@singer的歌
播放Delacey的歌	播放@singer的歌
播放崔健的歌	播放@singer的歌
播放庞龙的歌	播放@singer的歌
播放关诗敏的歌	播放@singer的歌
播放Mad Clown的歌	播放@singer的歌
播放望海高歌的歌	播放@singer的歌
播放卢冠廷的歌	播放@singer的歌
播放新街口组合的歌	播放@singer的歌
播放TWICE的歌	播放@singer的歌
播放霍尊的歌	播放@singer的歌
播放SISTAR的歌	播放@singer的歌
播放郑欣宜的歌	播放@singer的歌
播放Ed Sheeran的歌	播放@singer的歌
播放艾德·希兰的歌	播放@singer的歌
播放赵鑫的歌	播放@singer的歌
播放花澤香菜的歌	播放@singer的歌
播放苏立生的歌	播放@singer的歌
播放海生的歌	播放@singer的歌
播放17	播放@song
播放23	播放@song
播放365	播放@song
播放1121	播放@song
播放7月11日	播放@song
播放1314520	播放@song
播放南山南	播放@song
播放08年我们结婚	播放@song
播放1 TO 10	播放@song
播放15秒开嗨	播放@song
播放17岁	播放@song
播放1980年代的爱情	播放@song
播放1987我不知会遇见你	播放@song
播放1炮而红	播放@song
播放2! 3!	播放@song
播放2002年的第一场雪	播放@song
播放20岁的某一天	播放@song
播放24K Magic	播放@song
播放3 Things	播放@song
播放365 Valentine	播放@song
播放39 Ode To Oi.m4a	播放@song
播放3D环绕车载电子	播放@song
播放3D气氛环绕	播放@song
播放4号病房	播放@song
播放7 Years And 50 Days	播放@song
播放7家专用神曲	播放@song
播放7妹万万岁	播放@song
播放7氏皇家礼炮	播放@song
播放80后酒吧	播放@song
播放831战歌	播放@song
播放A Better Man	播放@song
播放A Bitter Day	播放@song
播放A Car, a Torch, a Death	播放@song
播放A Clue	播放@song
播放A Place In This World	播放@song
播放A Sky Full Of Stars	播放@song
播放A Talk	播放@song
播放A.I	播放@song
播放A.I.N.Y.	播放@song
播放A/Z	播放@song
播放A+E	播放@song
播放Acoustic Installation	播放@song
播放Addict With a Pen	播放@song
播放Addicted to a Memory	播放@song
播放Addiction	播放@song
播放Adore You	播放@song
播放Adrenaline	播放@song
播放Adventure Of A Lifetime	播放@song
播放After The Afterparty	播放@song
播放After the Winter	播放@song
播放Again	播放@song
播放Again and again	播放@song
播放Against The Odds	播放@song
播放Ain't no Way	播放@song
播放Air Catcher	播放@song
播放AIRPLANE	播放@song
播放Akon	播放@song
播放Alegría	播放@song
播放aLIEz	播放@song
播放Alive	播放@song
播放All About That Bass	播放@song
播放All for Joy	播放@song
播放All I Have	播放@song
播放All I Want For Christmas Is My Two Front Teeth	播放@song
播放All I Want for Christmas is You	播放@song
播放All I Want Is You	播放@song
播放All I Wanted Was You	播放@song
播放All In My Head	播放@song
播放All In Your Mind	播放@song
播放All My Love	播放@song
播放All Of Me	播放@song
播放All That Love	播放@song
播放All We Know	播放@song
播放Alone	播放@song
播放Alone In Love	播放@song
播放Alone Together	播放@song
播放Altitude	播放@song
播放Always	播放@song
播放Always Online	播放@song
播放Amaranth	播放@song
播放Amazed	播放@song
播放ambiguous	播放@song
播放Amen	播放@song
播放Andy	播放@song
播放Angel	播放@song
播放Angel by the Wings	播放@song
播放Animals	播放@song
播放Any Way You Want It	播放@song
播放Anything Could Happen	播放@song
播放Anything I'm Not	播放@song
播放Anywhere For You	播放@song
播放AOA	播放@song
播放Apologize	播放@song
播放Appreciated	播放@song
播放As Long As You Love Me	播放@song
播放Ass Hypnotized	播放@song
播放at’aek ON taitn	播放@song
播放Auld Lang Syne	播放@song
播放Aurora with Eri Kamiya	播放@song
播放Baby	播放@song
播放Baby Baby	播放@song
播放Baby Boy	播放@song
播放Baby Don't Go	播放@song
播放Baby Good Night	播放@song
播放Baby I Love You	播放@song
播放Baby Love	播放@song
播放Baby Making Interlude	播放@song
播放Baby Sister	播放@song
播放Back At One	播放@song
播放Back For More	播放@song
播放Back Home	播放@song
播放Back To Earth	播放@song
播放Back Where I Belong	播放@song
播放Bad	播放@song
播放Bad Day	播放@song
播放Bad Girl	播放@song
播放Bake Sale	播放@song
播放Bandvorstellung Muttersprache	播放@song
播放Bang Bang Bang	播放@song
播放Bang My Head	播放@song
播放Battle Cry	播放@song
播放Battleborne	播放@song
播放Bauklotze	播放@song
播放Be Alright	播放@song
播放Be My Baby	播放@song
播放Be My Lover	播放@song
播放Be Together	播放@song
播放Be With You	播放@song
播放Beat It	播放@song
播放Beats Knockin	播放@song
播放Beautiful	播放@song
播放Beautiful Excuses	播放@song
播放Beautiful Eyes	播放@song
播放Beautiful Life	播放@song
播放Beautiful Love	播放@song
播放Beautiful Now	播放@song
播放Beautiful Time	播放@song
播放Beauty and the Beast	播放@song
播放Because Of You	播放@song
播放Before The Goodbye	播放@song
播放Before You Start Your Day	播放@song
播放Behind The Mask	播放@song
播放Believe That	播放@song
播放Believer	播放@song
播放Berzerk	播放@song
播放Best I Never Had	播放@song
播放Best Of Joy	播放@song
播放Best of me	播放@song
播放Best Song Ever	播放@song
播放Better life	播放@song
播放Better Man	播放@song
播放Better Me	播放@song
播放Better When I'm Dancin'	播放@song
播放Bianling Boogie	播放@song
播放Big Girls Cry	播放@song
播放Bigbang	播放@song
播放Billie Jean	播放@song
播放Bitch Better Have My Money	播放@song
播放Bitchin' Summer	播放@song
播放BiuBiuBiu	播放@song
播放Black	播放@song
播放Black White	播放@song
播放Blacklist	播放@song
播放Blame	播放@song
播放Blame It On Me	播放@song
播放Blaze Up The Fire	播放@song
播放BLAZING	播放@song
播放Bloodstream	播放@song
播放Blow Me	播放@song
播放Blow Me A Kiss	播放@song
播放Blue	播放@song
播放Blue Skies	播放@song
播放Blue Water	播放@song
播放Bo Peep Bo Peep	播放@song
播放BO$$	播放@song
播放Boardmeeting	播放@song
播放BODY	播放@song
播放Body Rock	播放@song
播放Bonnie & Clyde	播放@song
播放Boom Boom Boom	播放@song
播放Boom Boom Pow	播放@song
播放Boom Clap	播放@song
播放BOOMBAYAH	播放@song
播放Booty Music	播放@song
播放Bounce	播放@song
播放Bounce Generation	播放@song
播放Boy In Luv	播放@song
播放Boyfriend	播放@song
播放Boys	播放@song
播放Boys Will Be Boys	播放@song
播放Brake Lights	播放@song
播放Break Free	播放@song
播放Break The Rules	播放@song
播放Break Ya Back	播放@song
播放Breaking News	播放@song
播放Breathe	播放@song
播放Breathless	播放@song
播放Brighter Side	播放@song
播放Bring Me Down	播放@song
播放Bringing You Love	播放@song
播放Broken Record	播放@song
播放Brown Eyes	播放@song
播放BTS	播放@song
播放BTS Cypher 4	播放@song
播放Bubble Butt	播放@song
播放Bubble Pop!	播放@song
播放Bubbly	播放@song
播放Buona morte	播放@song
播放Burn	播放@song
播放Bye Bye	播放@song
播放Bye Bye Beautiful	播放@song
播放Cake	播放@song
播放Call me baby	播放@song
播放Call Me Maybe	播放@song
播放Call On Love	播放@song
播放Call Waiting	播放@song
播放Call your name	播放@song
播放Can U Get Wit It	播放@song
播放Can You Feel It	播放@song
播放Can’t Let You Go	播放@song
播放Can't Believe It	播放@song
播放Can't Feel My Face	播放@song
播放Can't Have	播放@song
播放Can't Remember to Forget You	播放@song
播放Can't Stop	播放@song
播放Can't Stop Drinking About You	播放@song
播放CAN'T STOP THE FEELING!	播放@song
播放Can't Take My Eyes Off You	播放@song
播放Carry Out	播放@song
播放Castle on the Hill	播放@song
播放Catch me when I fall	播放@song
播放Catch My Breath	播放@song
播放Caught Up	播放@song
播放Celebrate	播放@song
播放Centuries	播放@song
播放Cetus	播放@song
播放Chandelier	播放@song
播放CHANGE	播放@song
播放Change Shoes	播放@song
播放Change The World	播放@song
播放Change Your Life	播放@song
播放Cheap Thrills	播放@song
播放Cheater	播放@song
播放CHEER UP	播放@song
播放Chemical Bus	播放@song
播放Chocolate	播放@song
播放Christmas In My Heart	播放@song
播放Christmas Trees	播放@song
播放Christopher	播放@song
播放Cinderella	播放@song
播放Cinderella Girl	播放@song
播放Circles	播放@song
播放Circus	播放@song
播放City View	播放@song
播放Clap ta This	播放@song
播放Clarity	播放@song
播放Classe 83	播放@song
播放Closer	播放@song
播放Clsr	播放@song
播放Coastal Cat	播放@song
播放Cold	播放@song
播放Cold As Ice	播放@song
播放Cold As You	播放@song
播放Cold Water	播放@song
播放Colorful Days	播放@song
播放Colors	播放@song
播放Come & Get It	播放@song
播放Come Back Down	播放@song
播放Come Back Home	播放@song
播放Come Over	播放@song
播放Come So Far	播放@song
播放Coming Over	播放@song
播放Confusion Girl	播放@song
播放contrast	播放@song
播放Cool	播放@song
播放Counting Stars	播放@song
播放Cowboy	播放@song
播放CPH Girls	播放@song
播放Crank	播放@song
播放Crawling	播放@song
播放Crazy	播放@song
播放Crazy Baby	播放@song
播放Crazy Girl	播放@song
播放CREAM	播放@song
播放Crime	播放@song
播放Crooked	播放@song
播放Cry	播放@song
播放Cry Me A River	播放@song
播放Crystals	播放@song
播放Curiosity	播放@song
播放Cut Me Deep	播放@song
播放Daddy	播放@song
播放Daffodils	播放@song
播放Dance Jockey	播放@song
播放Dance Medley	播放@song
播放Dancing In the Dark	播放@song
播放Dancing young	播放@song
播放Danger	播放@song
播放Dangerous	播放@song
播放Dangerous and Sweet	播放@song
播放Dangerous Woman	播放@song
播放Dangerously	播放@song
播放Dare	播放@song
播放Dark Side	播放@song
播放Darlin'	播放@song
播放day by day	播放@song
播放Dear Future Husband	播放@song
播放Dear My Wife	播放@song
播放Deer In The Headlights	播放@song
播放DELETE	播放@song
播放Delight	播放@song
播放Demo	播放@song
播放Demons	播放@song
播放Dennis	播放@song
播放Destiny	播放@song
播放Diamonds	播放@song
播放Die Young	播放@song
播放Different	播放@song
播放Disturbia	播放@song
播放DJ Got Us Fallin In Love	播放@song
播放DJ万万岁	播放@song
播放DJ重低音	播放@song
播放Do It In The AM	播放@song
播放Do It Like a Dude	播放@song
播放Do It On My Own	播放@song
播放DOA	播放@song
播放Does It Feel	播放@song
播放Doing It	播放@song
播放Doing It Right	播放@song
播放Doing Too Much	播放@song
播放Domino	播放@song
播放Don't	播放@song
播放Don't Give A Damn	播放@song
播放Don't Let Me Down	播放@song
播放Don't Let Me Fall	播放@song
播放Don't Matter	播放@song
播放Don't Mess With My Love	播放@song
播放Don't Say Goodbye	播放@song
播放Don't Say You Love Me	播放@song
播放Don't Speak	播放@song
播放Don't Wanna Know	播放@song
播放Doom Doom	播放@song
播放Dope	播放@song
播放Down	播放@song
播放Dr Bieber	播放@song
播放Drag Me Down	播放@song
播放Dragon	播放@song
播放Dragon Rider	播放@song
播放Dramatic Slow Motion	播放@song
播放Dream It Possible	播放@song
播放Dream lantern	播放@song
播放Dream Tonight	播放@song
播放Drenched	播放@song
播放Drop That	播放@song
播放Drunk In Love	播放@song
播放Dust Clears	播放@song
播放Dying For You	播放@song
播放Earned It	播放@song
播放Easy	播放@song
播放Elegy	播放@song
播放Elevated	播放@song
播放Emotion	播放@song
播放Empire	播放@song
播放Epic	播放@song
播放Essential Mix Radio	播放@song
播放Eternal Love	播放@song
播放Ever Lasting Love Song	播放@song
播放Everglow	播放@song
播放Every Time I Close My Eyes	播放@song
播放Everybody	播放@song
播放Everything Will Say Goodbye	播放@song
播放Everything You Do	播放@song
播放Everytime	播放@song
播放Evil In The Night	播放@song
播放Excuse Me	播放@song
播放Explode	播放@song
播放Extraordinary	播放@song
播放EXXXTASY	播放@song
播放Fade	播放@song
播放Fade Into Darkness	播放@song
播放Faded	播放@song
播放Faint	播放@song
播放Faistrap	播放@song
播放Faith Won't Fail	播放@song
播放Fall Away	播放@song
播放Fall to Light	播放@song
播放Fallin For You	播放@song
播放Falling Fast	播放@song
播放Falling In Deeper	播放@song
播放Fantastic Magic	播放@song
播放Far Away From Home	播放@song
播放Favorite Nightmare	播放@song
播放FEAR	播放@song
播放Febreze	播放@song
播放Feel Awake	播放@song
播放FEEL LOVE	播放@song
播放Feel Right	播放@song
播放Feel so Close	播放@song
播放Feel the Love	播放@song
播放Feels So Good	播放@song
播放Fighter	播放@song
播放Final Goodbye	播放@song
播放Find You	播放@song
播放FIRE	播放@song
播放Fire Starter	播放@song
播放Fireball	播放@song
播放Fireflies	播放@song
播放FIRST LOVE	播放@song
播放Five Hundred Miles	播放@song
播放Fix It	播放@song
播放Flameheart	播放@song
播放Flashlight	播放@song
播放Floating	播放@song
播放FLOW	播放@song
播放flower	播放@song
播放Fly	播放@song
播放Flying Without Wings	播放@song
播放Focus	播放@song
播放Follow Me	播放@song
播放Fool Again	播放@song
播放Foolish	播放@song
播放FOOLS	播放@song
播放Footprints On My Heart	播放@song
播放Footsteps	播放@song
播放For A Better Day	播放@song
播放For him.	播放@song
播放Force	播放@song
播放Force Of Nature	播放@song
播放Forever 21	播放@song
播放Forever Young	播放@song
播放FourFiveSeconds	播放@song
播放fragile	播放@song
播放Freak	播放@song
播放Freaks	播放@song
播放Freaky Girl	播放@song
播放Freal Luv	播放@song
播放Free	播放@song
播放Free Bird	播放@song
播放Free Loop	播放@song
播放Frenzy	播放@song
播放Friday Night Bitch Fight	播放@song
播放Friend, Please	播放@song
播放Friends	播放@song
播放Friendship to Last	播放@song
播放Frontlines	播放@song
播放Frosty the Snowman	播放@song
播放Funky Vodka	播放@song
播放FXXK IT	播放@song
播放Gala	播放@song
播放Galaxies	播放@song
播放Game Time	播放@song
播放Gangnam Style	播放@song
播放Gangsta Bop	播放@song
播放GDFR	播放@song
播放G-Dragon	播放@song
播放Gee	播放@song
播放GENIE	播放@song
播放Gentleman	播放@song
播放Get Down You're The One For Me	播放@song
播放Get Ghost	播放@song
播放Get In Line	播放@song
播放Get In the Trunk	播放@song
播放Get It In	播放@song
播放Get The Party Started	播放@song
播放Get Up	播放@song
播放Ghost Town	播放@song
播放Girl	播放@song
播放Girl In Your Dreams	播放@song
播放Girls Girls Girls	播放@song
播放Girls On the Dance Floor	播放@song
播放Give A Little Love	播放@song
播放Give It A Go	播放@song
播放Give It To Me	播放@song
播放Give Me A Sign	播放@song
播放Give Me Everything	播放@song
播放Give Me Life	播放@song
播放Give You What You Like	播放@song
播放Glass Ceiling	播放@song
播放Go	播放@song
播放GO GO GO	播放@song
播放God Is A Girl	播放@song
播放Gold	播放@song
播放Golden Gate 2016	播放@song
播放GOOD BOY	播放@song
播放Good Day	播放@song
播放Good Foot	播放@song
播放Good For You	播放@song
播放Good Girl	播放@song
播放Good Life	播放@song
播放Good Luck	播放@song
播放Good Time	播放@song
播放Goodbye	播放@song
播放Gotta Be Somebody	播放@song
播放Graveyard Standoff	播放@song
播放Grenade	播放@song
播放grilletto	播放@song
播放Groove	播放@song
播放Growing Pains	播放@song
播放GunduzI	播放@song
播放Guts Over Fear	播放@song
播放Hair Up	播放@song
播放Halo	播放@song
播放Halt mich	播放@song
播放Hands in the Air	播放@song
播放Hands Of Love	播放@song
播放Hands To Myself	播放@song
播放Hangover	播放@song
播放Happy Ending	播放@song
播放Happy Little Pill	播放@song
播放Haunted	播放@song
播放Have Some Fun	播放@song
播放haze	播放@song
播放Heads Up Phones Down	播放@song
播放Heart	播放@song
播放Heart Attack	播放@song
播放Heart On Fire	播放@song
播放Heartbeat	播放@song
播放Heartbeat Song	播放@song
播放Heartbreak Down	播放@song
播放Heartbreaker	播放@song
播放Heaven	播放@song
播放Heavy and Rolling	播放@song
播放Helium	播放@song
播放Hello	播放@song
播放Hello Baby	播放@song
播放Hello Friday	播放@song
播放Hello Kitty	播放@song
播放Hello Seattle	播放@song
播放Hello 大叔	播放@song
播放Her Story	播放@song
播放Here It Is	播放@song
播放Here We Are	播放@song
播放Here With You	播放@song
播放Here's To Never Growing Up	播放@song
播放Hey	播放@song
播放Hey Brother	播放@song
播放Hey Mama	播放@song
播放Hi 男朋友	播放@song
播放Hidden Track	播放@song
播放High High	播放@song
播放Higher	播放@song
播放Higher Ground	播放@song
播放High歌	播放@song
播放History	播放@song
播放Hold My Breath	播放@song
播放hold不住的爱	播放@song
播放Hold住你的心	播放@song
播放Holiday	播放@song
播放Holidays	播放@song
播放Holla Out	播放@song
播放Hollywood Tonight	播放@song
播放Home	播放@song
播放Home To Mama	播放@song
播放Hood	播放@song
播放HOOT	播放@song
播放Hope	播放@song
播放HOT PINK	播放@song
播放Hot Stuff	播放@song
播放Hotel Ceiling	播放@song
播放How Am I Supposed To Live Without You	播放@song
播放How Deep Is Your Love	播放@song
播放How Do I Look	播放@song
播放How Long Will I Love You	播放@song
播放How Would You Feel	播放@song
播放How Ya Feelin	播放@song
播放How You Remind Me	播放@song
播放Humbug	播放@song
播放Hungover	播放@song
播放Hurt So Good	播放@song
播放Hush Hush	播放@song
播放I Believe爱不离	播放@song
播放I Bet My Life	播放@song
播放I Can't Lose	播放@song
播放I Can't Make It	播放@song
播放I Could Be The One	播放@song
播放I Cry	播放@song
播放I Do	播放@song
播放I Don't Like It, I Love It	播放@song
播放I Don't Wanna Cry	播放@song
播放I Feel It Coming	播放@song
播放I Got Soul	播放@song
播放I Gotta Feeling	播放@song
播放I Have A Dream	播放@song
播放I Just Wanna Run	播放@song
播放I Lied	播放@song
播放I Like	播放@song
播放I Like That	播放@song
播放I Like The Way You Love Me	播放@song
播放I Lomo You	播放@song
播放I Love It	播放@song
播放I Love U Ok?	播放@song
播放I Love You	播放@song
播放I Love You Forever	播放@song
播放I Miss You	播放@song
播放I MISS YOU SO BAD	播放@song
播放I Need A Girl	播放@song
播放I NEED U	播放@song
播放I Need You	播放@song
播放I Need Your Love	播放@song
播放I Never Forget	播放@song
播放I Run Away	播放@song
播放I See Fire	播放@song
播放I Stay In Love	播放@song
播放I Swear	播放@song
播放I Wanna Be With You	播放@song
播放I Wanna Fly	播放@song
播放I Wanna Go	播放@song
播放I Want It	播放@song
播放I Want My Tears Back	播放@song
播放I Want You	播放@song
播放I Want You To Know	播放@song
播放I will be Loving You	播放@song
播放I Will Take You Home	播放@song
播放I wonder why…	播放@song
播放I Won't Give Up	播放@song
播放I Won't Let You Down	播放@song
播放I Won't Tell A Soul	播放@song
播放Ice Cream	播放@song
播放If I Had You	播放@song
播放If I Let You Go	播放@song
播放If I Lose Myself	播放@song
播放If I Was You	播放@song
播放If I Were A Boy	播放@song
播放If We Ever Meet Again	播放@song
播放If You	播放@song
播放If You Leave Me Now	播放@song
播放Ignite	播放@song
播放I'll Be Down For You	播放@song
播放I'll Be Home	播放@song
播放I'll Be OK	播放@song
播放I'll Be There	播放@song
播放I'll Make It Right	播放@song
播放I'll Never Break Your Heart	播放@song
播放I'll Show You Love	播放@song
播放I'm a Lady	播放@song
播放I'm A Slave 4 U	播放@song
播放I'm All Good	播放@song
播放I'm Dj小可	播放@song
播放I'M HIM	播放@song
播放I'm In Here	播放@song
播放I'm In Love With a Monster	播放@song
播放I'm No Superstar	播放@song
播放I'm Not A Girl, Not Yet A Woman	播放@song
播放I'm Not Okay	播放@song
播放I'm Not Sorry	播放@song
播放I'm sorry	播放@song
播放I'm Yours	播放@song
播放Immortals	播放@song
播放Implicit Demand for Proof	播放@song
播放In And Out Of Love	播放@song
播放In Case	播放@song
播放In Case of Fire	播放@song
播放In The Air Tonight	播放@song
播放In The End	播放@song
播放In The Night	播放@song
播放Infinite Power!	播放@song
播放Infinity	播放@song
播放Inside Out	播放@song
播放International Love	播放@song
播放Interstellar	播放@song
播放Intro	播放@song
播放Intuition	播放@song
播放Invasion	播放@song
播放Invisible	播放@song
播放Iridescent	播放@song
播放Irresistible	播放@song
播放IR战歌	播放@song
播放Is Anybody Out There	播放@song
播放Is This Love	播放@song
播放iSay	播放@song
播放Island	播放@song
播放Isle of Flightless Birds	播放@song
播放It's Disgusting	播放@song
播放It's Love	播放@song
播放Its My Time	播放@song
播放It's Quiet Uptown	播放@song
播放It's So Hard To Say Goodbye To Yesterday	播放@song
播放It's Time	播放@song
播放Jackpot	播放@song
播放Jai Ho!	播放@song
播放Jam	播放@song
播放Jamcome On Baby	播放@song
播放Jar Of Love	播放@song
播放JC	播放@song
播放JELLY JELLY	播放@song
播放Jimmy Gets High	播放@song
播放Jingle Bell Rock	播放@song
播放Jingle Bells	播放@song
播放Johnny Boy	播放@song
播放Julia	播放@song
播放Juliet	播放@song
播放July	播放@song
播放Jungle Bae	播放@song
播放Just Give Me a Reason	播放@song
播放Just Like Fire	播放@song
播放Just Now	播放@song
播放Just One Last Dance	播放@song
播放Just the Way You Are	播放@song
播放Just To Be Close To You	播放@song
播放Kaleidoscope	播放@song
播放Kaleidoscope Eyes	播放@song
播放Kanye	播放@song
播放Keep on keeping on	播放@song
播放Keep On Waiting	播放@song
播放Keep You Much Longer	播放@song
播放Keep Your Head Up	播放@song
播放Khaleesi	播放@song
播放Kill Em With Kindness	播放@song
播放Kingdom	播放@song
播放Kiss	播放@song
播放Knock Knock	播放@song
播放Kong	播放@song
播放Korean Dream	播放@song
播放L.I.E	播放@song
播放L.I.F.E.	播放@song
播放Lamb	播放@song
播放Lamb.	播放@song
播放Last Call	播放@song
播放Last Christmas	播放@song
播放LAST DANCE	播放@song
播放Last Ride Of The Day	播放@song
播放Latin Girl	播放@song
播放Law of the Jungle	播放@song
播放Lay It All On Me	播放@song
播放Lean On	播放@song
播放Leave Out All The Rest	播放@song
播放Leaving Los Feliz	播放@song
播放Lemon Tree	播放@song
播放Let It Go	播放@song
播放Let Me Go	播放@song
播放Let the Road	播放@song
播放Let You Go	播放@song
播放Let's Get It Started	播放@song
播放Let's Go	播放@song
播放Let's Go Out Tonight	播放@song
播放Let's Go Party	播放@song
播放Let's Have A Party	播放@song
播放Let's Hurt Tonight	播放@song
播放Let's Start From Here	播放@song
播放Levels	播放@song
播放Levitate	播放@song
播放Lie To Me	播放@song
播放Life	播放@song
播放Life Is Like A Song	播放@song
播放Life Of The Party	播放@song
播放Light It Up	播放@song
播放Lights	播放@song
播放Like A Bird	播放@song
播放Like A G6	播放@song
播放Like a Song	播放@song
播放Like I'm Gonna Lose You	播放@song
播放Lily	播放@song
播放Limousine	播放@song
播放LINE	播放@song
播放Lips Are Movin	播放@song
播放Lit	播放@song
播放Little Fish	播放@song
播放Live And Love Your Life	播放@song
播放Live Like You're Dying	播放@song
播放Live My Life	播放@song
播放Live on Yoo Hee Yeol's Sketchbook	播放@song
播放Living In the Moment	播放@song
播放Living Proof	播放@song
播放Living To Love You	播放@song
播放LOADING	播放@song
播放Loca por Ti	播放@song
播放Locked Out of Heaven	播放@song
播放Logjammin	播放@song
播放LOL	播放@song
播放London Queen	播放@song
播放Lonely	播放@song
播放Long Shot	播放@song
播放Look At Me Now	播放@song
播放LOSER	播放@song
播放Lost	播放@song
播放Lost Control	播放@song
播放Lost in Paradise	播放@song
播放Lost On The Stoop	播放@song
播放Lost You	播放@song
播放LOVE	播放@song
播放Love !	播放@song
播放Love Again	播放@song
播放Love Club	播放@song
播放Love Girl	播放@song
播放Love Is All	播放@song
播放Love Is Color Blind	播放@song
播放LOVE IS YOU	播放@song
播放Love Like This	播放@song
播放Love Me Harder	播放@song
播放Love Me Like You Do	播放@song
播放Love me right	播放@song
播放Love Paradise	播放@song
播放Love Runs Out	播放@song
播放Love Someone	播放@song
播放Love Song	播放@song
播放Love Takes Time	播放@song
播放Love The Way You Lie	播放@song
播放Love U2	播放@song
播放Love Was Here	播放@song
播放Love Will Remember	播放@song
播放LOVE YOU	播放@song
播放Love You Better	播放@song
播放Love You Lately	播放@song
播放Love You Like a Love Song	播放@song
播放Love Yourself	播放@song
播放Love! Love! Aloha!	播放@song
播放Lovely	播放@song
播放Lovers On the Sun	播放@song
播放Lovey Dovey	播放@song
播放Loving You	播放@song
播放Lucky	播放@song
播放Lucky Boys	播放@song
播放Lucky Lucky	播放@song
播放Lullaby	播放@song
播放Luv's farewell	播放@song
播放Lydia	播放@song
播放M.O.M	播放@song
播放MACHINE GUN	播放@song
播放Mad World	播放@song
播放Made in the USA	播放@song
播放Made Out With A Rockstar	播放@song
播放Magic	播放@song
播放Make A Play	播放@song
播放Make it Mine	播放@song
播放Make Me Cry	播放@song
播放Make Out	播放@song
播放Making Love Out of Nothing at All	播放@song
播放MAMA	播放@song
播放Mamasita	播放@song
播放Mandy	播放@song
播放Maps	播放@song
播放March to the Sea	播放@song
播放Marmalade Jam	播放@song
播放Marry me	播放@song
播放Marry Me2020	播放@song
播放Marry You	播放@song
播放Marvin Gaye	播放@song
播放Masterpiece	播放@song
播放Me & My Girls	播放@song
播放Me And My Broken Heart	播放@song
播放Me Too	播放@song
播放Medicine	播放@song
播放Melody	播放@song
播放Melt The Snow	播放@song
播放Memory	播放@song
播放Mercy	播放@song
播放Microcosm	播放@song
播放Million Voices	播放@song
播放Mind	播放@song
播放MIRAI	播放@song
播放Mirror Mirror	播放@song
播放Mirrors	播放@song
播放Miss You	播放@song
播放Missing You	播放@song
播放Mistletoe	播放@song
播放Money Money	播放@song
播放moneyflow	播放@song
播放Monica	播放@song
播放Monody	播放@song
播放Monster	播放@song
播放Moonlight shadow	播放@song
播放More Than A Memory	播放@song
播放More Than Words	播放@song
播放Most Of Us	播放@song
播放Mouth	播放@song
播放Move Your Body	播放@song
播放Moves Like Jagger	播放@song
播放Mozart's House	播放@song
播放Mr. DJ	播放@song
播放MR. TAXI	播放@song
播放Mr.Curiosity	播放@song
播放Much Too Soon	播放@song
播放My Dilemma	播放@song
播放My Father's Daughter	播放@song
播放My Freedom	播放@song
播放My Girl	播放@song
播放MY HEAVEN	播放@song
播放My House	播放@song
播放My Humps	播放@song
播放My little happiness	播放@song
播放My Love	播放@song
播放My Love My Fate	播放@song
播放My Man	播放@song
播放My Mercedes	播放@song
播放My Number	播放@song
播放MY OWN LIFE	播放@song
播放My Own Monster	播放@song
播放My Songs Know What You Did In The Dark Light Em Up	播放@song
播放MY TYPE	播放@song
播放My Way	播放@song
播放MYM	播放@song
播放Nandemonaiya	播放@song
播放Naturally	播放@song
播放Need 2 Show	播放@song
播放Need a Little Love	播放@song
播放Need To Know	播放@song
播放Nemo	播放@song
播放Neon Lights	播放@song
播放Never Be Alone	播放@song
播放Never Been Hurt	播放@song
播放Never Let You Go	播放@song
播放New Boy	播放@song
播放New day	播放@song
播放New Divide	播放@song
播放New Soul	播放@song
播放Next To Me	播放@song
播放Night Changes	播放@song
播放Nightingale	播放@song
播放Nightwish	播放@song
播放Niliria	播放@song
播放NO	播放@song
播放No Champagne	播放@song
播放No Girlfriend	播放@song
播放No No No	播放@song
播放No Permission	播放@song
播放No Promises	播放@song
播放No Typical Thursday Night	播放@song
播放No U Hang Up	播放@song
播放NO.9	播放@song
播放Nobody	播放@song
播放Nobody But You	播放@song
播放Nobody Gotta Know	播放@song
播放Nosy Neighbour	播放@song
播放Not Afraid	播放@song
播放Not Alone	播放@song
播放Not Giving In	播放@song
播放Not Today	播放@song
播放Nothing Better	播放@song
播放Nothing Compares 2 U	播放@song
播放Nothing’s Gonna Change My Love For You	播放@song
播放Numb	播放@song
播放Nunca Me Acuerdo de Olvidarte	播放@song
播放Nuttin' For Christmas	播放@song
播放Nympho	播放@song
播放Objection	播放@song
播放Oceans Between Us	播放@song
播放Ode To Oi	播放@song
播放Oh Ms Believer	播放@song
播放Oh My God	播放@song
播放Oh Timbaland	播放@song
播放Oh Yeah	播放@song
播放OKEY DOKEY	播放@song
播放On My Mind	播放@song
播放On My Way	播放@song
播放On The Edge	播放@song
播放On The Radio	播放@song
播放On Top of the World	播放@song
播放Once In A Lifetime	播放@song
播放One Call Away	播放@song
播放One Day	播放@song
播放One Fine Wire	播放@song
播放ONE IN A MILLION	播放@song
播放One Last Time	播放@song
播放One More Day	播放@song
播放One More Night	播放@song
播放One More Time	播放@song
播放one more time,one more chance	播放@song
播放One Night In 北京	播放@song
播放One Of Those Nights	播放@song
播放Only Girl	播放@song
播放Only love	播放@song
播放Ooh La La	播放@song
播放Open Your Heart	播放@song
播放Operetten Gala - Wolgalied	播放@song
播放Ordinary People	播放@song
播放Oregon	播放@song
播放Our Song	播放@song
播放Out Of My Hands	播放@song
播放Outlaws Of Love	播放@song
播放Outside	播放@song
播放Overloved	播放@song
播放Pack Light	播放@song
播放Palm	播放@song
播放Papercut	播放@song
播放Parachute	播放@song
播放Paradise	播放@song
播放Paris	播放@song
播放Partition	播放@song
播放Payphone	播放@song
播放People Like Us	播放@song
播放Perfect	播放@song
播放Photograph	播放@song
播放Piece By Piece	播放@song
播放Piercing	播放@song
播放PiNK CAT	播放@song
播放PIT-A-PAT	播放@song
播放PLAY	播放@song
播放Play Hard	播放@song
播放PLAYING WITH FIRE	播放@song
播放Play我呸	播放@song
播放Poison	播放@song
播放Polar	播放@song
播放PONYTAIL	播放@song
播放Pop Leader	播放@song
播放Possible	播放@song
播放Pour Up	播放@song
播放Powder Rangers	播放@song
播放Powerful	播放@song
播放PPAP	播放@song
播放PPAP笔菠萝波波苹果笔	播放@song
播放PPAP神曲	播放@song
播放Pray to God	播放@song
播放Prelude	播放@song
播放Pretenders	播放@song
播放Pretty Boy	播放@song
播放Pretty Hurts	播放@song
播放Price Tag	播放@song
播放PRICKED	播放@song
播放Prisoner	播放@song
播放Problem	播放@song
播放Put My Hands On You	播放@song
播放Quit Playing Games	播放@song
播放R.O.D.	播放@song
播放Radioactive	播放@song
播放Rain Over Me	播放@song
播放Raindrops Keep Fallin' On My Head	播放@song
播放Raise Your Glass	播放@song
播放Rap God	播放@song
播放Rap Star	播放@song
播放Rather Be	播放@song
播放Ready Aim Fire	播放@song
播放Real	播放@song
播放Real Love	播放@song
播放Realize	播放@song
播放Really Don't Care	播放@song
播放Red Balloon	播放@song
播放Reflection	播放@song
播放Remind You	播放@song
播放Reminder	播放@song
播放Reset	播放@song
播放RHYTHM TA	播放@song
播放Right Here Waiting	播放@song
播放Right Now	播放@song
播放Right There	播放@song
播放Rihanna	播放@song
播放Rimbomba	播放@song
播放Ring Off	播放@song
播放Riot On the Dancefloor	播放@song
播放Rise	播放@song
播放River	播放@song
播放Roar	播放@song
播放Rock	播放@song
播放Rock n Roll	播放@song
播放Rock That Body	播放@song
播放Rockabye	播放@song
播放Rocketeer	播放@song
播放Rockin' Around The Christmas Tree	播放@song
播放Roll The Bass	播放@song
播放Roll With It	播放@song
播放Roots	播放@song
播放Roses	播放@song
播放Routine	播放@song
播放Rude Boy	播放@song
播放Rudolph the Red Nosed Reindeer	播放@song
播放Ruin	播放@song
播放Rumour Mill	播放@song
播放Run	播放@song
播放Run Devil Run	播放@song
播放Run Run Run	播放@song
播放Run This	播放@song
播放Run Up	播放@song
播放Runaway	播放@song
播放Runaway Baby	播放@song
播放Running	播放@song
播放Running Away	播放@song
播放S&M	播放@song
播放Same Old Love	播放@song
播放Santa Claus Is Coming To Town	播放@song
播放Santa Tell Me	播放@song
播放Sarah Connor feat. Mr. Freeman - Paradise	播放@song
播放Satisfied	播放@song
播放Save My Night	播放@song
播放Save Rock And Roll	播放@song
播放Save Your Heart	播放@song
播放Say Goodbye	播放@song
播放Say I Do	播放@song
播放Say Something	播放@song
播放Say Yes	播放@song
播放ScaPEGoat	播放@song
播放Schmoyoho Accent On The yo	播放@song
播放Search Me	播放@song
播放Seasons always change	播放@song
播放Seasons In The Sun	播放@song
播放Secret	播放@song
播放Secret Sensation	播放@song
播放Secrets	播放@song
播放See You Again	播放@song
播放Senorita	播放@song
播放Sent From Up Above	播放@song
播放SENTIMENTAL	播放@song
播放Setting Fires	播放@song
播放Seve	播放@song
播放Seven	播放@song
播放Sexy Bitch	播放@song
播放sexy love	播放@song
播放SexyBack	播放@song
播放Shady With Me	播放@song
播放Shake It	播放@song
播放Shape of You	播放@song
播放She	播放@song
播放She Is My Sin	播放@song
播放Shero	播放@song
播放SHERO Remix	播放@song
播放Shots	播放@song
播放Shouldn't Come Back	播放@song
播放Show You	播放@song
播放Side To Side	播放@song
播放Signal	播放@song
播放Silent Miss	播放@song
播放Silent Night	播放@song
播放Silent Times	播放@song
播放Silhouettes	播放@song
播放Sing	播放@song
播放Sing Me to Sleep	播放@song
播放Single	播放@song
播放Single Ladies	播放@song
播放Skipalong	播放@song
播放Sky	播放@song
播放Sledgehammer	播放@song
播放Slide	播放@song
播放Slow Down	播放@song
播放Slow Love	播放@song
播放Slow Motion	播放@song
播放Smile Again	播放@song
播放Smooth Criminal	播放@song
播放So Cold	播放@song
播放So Cool	播放@song
播放So High	播放@song
播放So What	播放@song
播放Sober	播放@song
播放Some Type Of Love	播放@song
播放Someday	播放@song
播放Someone To Love	播放@song
播放Something Just Like This	播放@song
播放Something Kind of Wonderful	播放@song
播放Something Right	播放@song
播放Something That We're Not	播放@song
播放Somewhere Over The Rainbow	播放@song
播放Song 6	播放@song
播放Sorry	播放@song
播放Soulmate	播放@song
播放Sound Of Silence	播放@song
播放Sound of the Drums	播放@song
播放Sparkle	播放@song
播放Sparks	播放@song
播放Speakerphone	播放@song
播放Spectre	播放@song
播放Spectrum	播放@song
播放Sphere	播放@song
播放Spiral Parade	播放@song
播放Split	播放@song
播放Spotlight	播放@song
播放Spring Day	播放@song
播放Stan	播放@song
播放Stand	播放@song
播放Star Sky	播放@song
播放Starboy	播放@song
播放Stay	播放@song
播放Stay Beautiful	播放@song
播放Stay Here Forever	播放@song
播放Stay the Night	播放@song
播放Stay With Me	播放@song
播放Steal My Girl	播放@song
播放Still Falling For You	播放@song
播放Stitches	播放@song
播放Story Of My Life	播放@song
播放Stratton Oakmont 2015	播放@song
播放Strength Of A Thousand Men	播放@song
播放Stressed Out	播放@song
播放Stronger	播放@song
播放Struck By Lightning	播放@song
播放Styrofoam	播放@song
播放Suffer	播放@song
播放Sugar	播放@song
播放Sugar Free	播放@song
播放Suit & Tie featuring JAY Z	播放@song
播放Summer	播放@song
播放Summer Breaking	播放@song
播放Summer Rain	播放@song
播放Summer Time	播放@song
播放Sun	播放@song
播放Sun And Moon	播放@song
播放Sunburst	播放@song
播放Sunday Morning	播放@song
播放Super Star	播放@song
播放Supernova	播放@song
播放Survival	播放@song
播放Suspect	播放@song
播放Swear It Again	播放@song
播放Sweet Dream	播放@song
播放Sweet Dreams	播放@song
播放sweets parade	播放@song
播放Symphony	播放@song
播放T.A.O	播放@song
播放TACTIX	播放@song
播放Take a Bow	播放@song
播放Take A Picture	播放@song
播放Take Back the Night	播放@song
播放Take It Off	播放@song
播放Take Me Away	播放@song
播放Take Me Back	播放@song
播放Take Me Home	播放@song
播放Take Me To Your Heart	播放@song
播放TALK ME DOWN	播放@song
播放Talk to Me	播放@song
播放Taxi	播放@song
播放Taxi Cab	播放@song
播放Teardrops on My Guitar	播放@song
播放Tears	播放@song
播放Thank U	播放@song
播放Thank You	播放@song
播放Thanks For Nothing	播放@song
播放That Girl	播放@song
播放That Good Good	播放@song
播放That's My Girl	播放@song
播放That's Where You Take Me	播放@song
播放That's Why	播放@song
播放That's Why You Go Away	播放@song
播放The Apl Song	播放@song
播放The Calling	播放@song
播放The Climb	播放@song
播放The Day You Went Away	播放@song
播放The Days	播放@song
播放The End	播放@song
播放The End Is The Beginning	播放@song
播放The Fault in Our Stars	播放@song
播放THE GREAT ESCAPE	播放@song
播放The Great Experiment	播放@song
播放The Greatest	播放@song
播放The Heart Wants What It Wants	播放@song
播放THE HERO	播放@song
播放The Hills	播放@song
播放The Jam	播放@song
播放The King Is Dead But the Queen Is Alive	播放@song
播放The Lazy Song	播放@song
播放The Life	播放@song
播放The Little Things	播放@song
播放The Lonely Goatherd	播放@song
播放The Many Ways	播放@song
播放The Mighty Fall	播放@song
播放The Monster	播放@song
播放The Nights	播放@song
播放The One Thing	播放@song
播放The Outside	播放@song
播放The Pantaloon	播放@song
播放The Phoenix	播放@song
播放The Reluctant Heroes	播放@song
播放The Rose	播放@song
播放The Saltwater Room	播放@song
播放The Show	播放@song
播放The Time	播放@song
播放The Twelve Days Of Christmas	播放@song
播放The Way I Are	播放@song
播放The Way We Are	播放@song
播放The Weight	播放@song
播放There's Got To Be A Way	播放@song
播放Think About the Way	播放@song
播放Think of You	播放@song
播放Thinking Out Loud	播放@song
播放This	播放@song
播放This Is What It Feels Like	播放@song
播放This Is What You Came For	播放@song
播放This Isn't the End	播放@song
播放This Kiss	播放@song
播放Thnks fr th Mmrs	播放@song
播放Tied Together With A Smile	播放@song
播放Tiger JK Says	播放@song
播放Tight With You	播放@song
播放Tik Tok	播放@song
播放Till the World Ends	播放@song
播放Tim McGraw	播放@song
播放Timber	播放@song
播放Time	播放@song
播放Time Lapse	播放@song
播放Time of Our Lives	播放@song
播放Title	播放@song
播放Today	播放@song
播放Today's The Day	播放@song
播放Together	播放@song
播放Told You So	播放@song
播放Too Original	播放@song
播放Too Young	播放@song
播放Touch	播放@song
播放Touch love	播放@song
播放Touch my body	播放@song
播放Touchdown	播放@song
播放Tower Tactics	播放@song
播放Toxic	播放@song
播放Trapdoor	播放@song
播放Treasure	播放@song
播放Treat You Better	播放@song
播放Trespassing	播放@song
播放Trouble Is a Friend	播放@song
播放Trouble Maker	播放@song
播放Troublemaker	播放@song
播放Trust In Me	播放@song
播放Try	播放@song
播放Tulips	播放@song
播放Turn Me on	播放@song
播放Turn Me Up	播放@song
播放Turn Up The Love	播放@song
播放Two Pieces	播放@song
播放U	播放@song
播放U&I	播放@song
播放UFO	播放@song
播放Uma Thurman	播放@song
播放Umbrella	播放@song
播放Underneath Your Clothes	播放@song
播放Unity	播放@song
播放unravel	播放@song
播放Unstoppable	播放@song
播放Until You	播放@song
播放Until You Were Gone	播放@song
播放Up & Down	播放@song
播放Up Again	播放@song
播放Uptown Funk	播放@song
播放Uptown's First Finale	播放@song
播放Used To Have It All	播放@song
播放Valentine's Day	播放@song
播放Vanishing	播放@song
播放Vava	播放@song
播放Vers La Lumiere	播放@song
播放Versace On The Floor	播放@song
播放Victim	播放@song
播放Visa vs Flashback	播放@song
播放Vision Of Love	播放@song
播放Viva La Vida	播放@song
播放Volume Up	播放@song
播放Vroom Vroom	播放@song
播放W 企划	播放@song
播放Wait On Me	播放@song
播放Waiting All Night	播放@song
播放Waiting For Love	播放@song
播放Waiting In the Wings	播放@song
播放Wake Me Up	播放@song
播放Walk Away	播放@song
播放Walkashame	播放@song
播放Walls	播放@song
播放Wanna Be Where You Are	播放@song
播放Wanna Be With You	播放@song
播放Warrior	播放@song
播放Warriors	播放@song
播放Waves	播放@song
播放We All Want The Same Thing	播放@song
播放We Are One	播放@song
播放We Are The World	播放@song
播放We Can Change the World	播放@song
播放We Can't Stop	播放@song
播放We Collide	播放@song
播放We Don't Talk Anymore	播放@song
播放We Found Love	播放@song
播放WE LIKE 2 PARTY	播放@song
播放We Shared The Night	播放@song
播放We Wanna Party	播放@song
播放We Will Not Grow Old	播放@song
播放We Wish You a Merry Christmas	播放@song
播放Wedding Dress	播放@song
播放Welcome To The Show	播放@song
播放Welcome to Wondaland	播放@song
播放We'll Be Coming Back	播放@song
播放We've Got It Goin' On	播放@song
播放What a Feeling	播放@song
播放What Are Words	播放@song
播放What Do You Mean?	播放@song
播放What Goes Around... Comes Around	播放@song
播放What I Need	播放@song
播放What if I said	播放@song
播放What Makes You Beautiful	播放@song
播放What U Need	播放@song
播放What You Are	播放@song
播放What You Do About Me	播放@song
播放What You Wanted	播放@song
播放what2do	播放@song
播放Whataya Want from Me	播放@song
播放What's up Suckaz	播放@song
播放When I Found You	播放@song
播放When I Was Your Man	播放@song
播放When It Was Me	播放@song
播放When There's Nothing Left	播放@song
播放When You're Around	播放@song
播放Where Are U Now	播放@song
播放Where Did That Go	播放@song
播放Where Did The Party Go	播放@song
播放Where is the love REMIX	播放@song
播放Where Is The Love?	播放@song
播放Where Them Girls At	播放@song
播放Whispers	播放@song
播放WHISTLE	播放@song
播放white silence	播放@song
播放Who Says	播放@song
播放Who You?	播放@song
播放Whole	播放@song
播放Who's That Chick?	播放@song
播放WHOZ THAT GIRL	播放@song
播放Why	播放@song
播放Why Would I Ever	播放@song
播放Wi Ing Wi Ing	播放@song
播放Wicked Games	播放@song
播放Wild	播放@song
播放Wild Ones	播放@song
播放Windfall	播放@song
播放Window	播放@song
播放With ELVIS	播放@song
播放With Out U	播放@song
播放With You	播放@song
播放Without the Love	播放@song
播放Wolf	播放@song
播放Wonderful	播放@song
播放Wonderland	播放@song
播放Woohoo	播放@song
播放Work From Home	播放@song
播放Worth It	播放@song
播放Wrecking Ball	播放@song
播放Writing's On The Wall	播放@song
播放X Song	播放@song
播放X.U.	播放@song
播放Xenogenesis	播放@song
播放XO	播放@song
播放XOXOXO	播放@song
播放Ya Ya Ya	播放@song
播放YAMANAIAME	播放@song
播放Yeah	播放@song
播放Yellow	播放@song
播放YES I DO	播放@song
播放Yes U Can	播放@song
播放Yesterday	播放@song
播放You & I	播放@song
播放You & Me	播放@song
播放You and I	播放@song
播放You and Me	播放@song
播放You Are	播放@song
播放You Are My Everything	播放@song
播放You Are Not Alone	播放@song
播放You Can Rely On Me	播放@song
播放You Don't Care About Me	播放@song
播放You Got Me	播放@song
播放You Gotta Be	播放@song
播放You Love Me	播放@song
播放You Need Me	播放@song
播放You Raise Me Up	播放@song
播放You Took My Heart	播放@song
播放You Were Wrong	播放@song
播放Young For You	播放@song
播放Young Street logo song	播放@song
播放Your Daddy	播放@song
播放Your Song	播放@song
播放Your Voice	播放@song
播放You're Not Alone	播放@song
播放YOUTH	播放@song
播放Youtopia	播放@song
播放Youtubers Life Rap	播放@song
播放Zenzenzense	播放@song
播放Zoney	播放@song
播放ZUTTER	播放@song
播放βios	播放@song
播放阿飞和他的那个女人	播放@song
播放阿拉善	播放@song
播放阿里郎	播放@song
播放阿里山的姑娘	播放@song
播放阿哲家封神榜	播放@song
播放唉声叹气	播放@song
播放爱	播放@song
播放爱 都是对的	播放@song
播放爱，哎	播放@song
播放爱，很简单	播放@song
播放爱，燃烧	播放@song
播放爱，有你才完整	播放@song
播放爱爱爱	播放@song
播放爱别离	播放@song
播放爱不单行	播放@song
播放爱不简单	播放@song
播放爱不疚	播放@song
播放爱不可及	播放@song
播放爱不释手	播放@song
播放爱出发	播放@song
播放爱到底	播放@song
播放爱到尽头也无悔	播放@song
播放爱得起	播放@song
播放爱得太迟	播放@song
播放爱德华的小说	播放@song
播放爱的代价	播放@song
播放爱的方向	播放@song
播放爱的歌曲送给你	播放@song
播放爱的供养	播放@song
播放爱的故事上集	播放@song
播放爱的海洋	播放@song
播放爱的记忆你曾来过	播放@song
播放爱的路上我和你	播放@song
播放爱的魔法	播放@song
播放爱的青春短	播放@song
播放爱的世界只有你	播放@song
播放爱的习惯	播放@song
播放爱的血泪史	播放@song
播放爱的勇气	播放@song
播放爱的箴言	播放@song
播放爱的主打歌	播放@song
播放爱多一次痛多一次	播放@song
播放爱妃	播放@song
播放爱疯痴	播放@song
播放爱疯了	播放@song
播放爱过	播放@song
播放爱过那张脸	播放@song
播放爱过你	播放@song
播放爱幻想的女孩	播放@song
播放爱江山更爱美人	播放@song
播放爱久见人心	播放@song
播放爱就一个字	播放@song
播放爱没如果	播放@song
播放爱没有谁对不起谁	播放@song
播放爱莫忘	播放@song
播放爱你	播放@song
播放爱你.离开你	播放@song
播放爱你爱不够	播放@song
播放爱你不是为了和你去如家	播放@song
播放爱你的声音	播放@song
播放爱你的我今天长这样	播放@song
播放爱你的宿命	播放@song
播放爱你的最后一天	播放@song
播放爱你没错	播放@song
播放爱你一辈子我愿意	播放@song
播放爱你一生	播放@song
播放爱你一万年	播放@song
播放爱拼才会赢	播放@song
播放爱情不是菜	播放@song
播放爱情闯进门	播放@song
播放爱情大实话	播放@song
播放爱情地图	播放@song
播放爱情发的光	播放@song
播放爱情防线	播放@song
播放爱情故事	播放@song
播放爱情好无奈	播放@song
播放爱情呼救999	播放@song
播放爱情来了	播放@song
播放爱情里没有谁对谁错	播放@song
播放爱情码头	播放@song
播放爱情没什么道理	播放@song
播放爱情面具	播放@song
播放爱情岁月	播放@song
播放爱情天堂	播放@song
播放爱情怎么喊停	播放@song
播放爱情之所以为爱情	播放@song
播放爱情专属权	播放@song
播放爱情转移	播放@song
播放爱囚	播放@song
播放爱人	播放@song
播放爱人爱情	播放@song
播放爱人别走	播放@song
播放爱如潮水	播放@song
播放爱若离	播放@song
播放爱若去了	播放@song
播放爱上爱情爱上你	播放@song
播放爱上你的一切	播放@song
播放爱上你等于爱上寂寞	播放@song
播放爱上你我很快乐	播放@song
播放爱上一个不回家的人	播放@song
播放爱神的小苹果	播放@song
播放爱似风筝	播放@song
播放爱似水仙	播放@song
播放爱是你我	播放@song
播放爱是一个疯字	播放@song
播放爱是永恒	播放@song
播放爱是最大权利	播放@song
播放爱逝枷锁	播放@song
播放爱输给了谁	播放@song
播放爱说远就远	播放@song
播放爱太空	播放@song
播放爱太难	播放@song
播放爱太痛	播放@song
播放爱投罗网	播放@song
播放爱我	播放@song
播放爱我，不爱我	播放@song
播放爱我，你怕了吗	播放@song
播放爱我的人和我爱的人	播放@song
播放爱我还是他	播放@song
播放爱我请留言	播放@song
播放爱无反顾	播放@song
播放爱无罪	播放@song
播放爱夏	播放@song
播放爱相随	播放@song
播放爱像棉花糖	播放@song
播放爱丫爱丫	播放@song
播放爱呀	播放@song
播放爱要撑下去	播放@song
播放爱要怎么说出口	播放@song
播放爱一点	播放@song
播放爱已欠费	播放@song
播放爱音乐	播放@song
播放爱有路可退	播放@song
播放爱有奇迹	播放@song
播放爱又爱	播放@song
播放爱与不爱之间	播放@song
播放爱与诚	播放@song
播放爱与痛的边缘	播放@song
播放爱在记忆中找你	播放@song
播放爱在深秋	播放@song
播放爱在天地间	播放@song
播放爱之声	播放@song
播放爱转角	播放@song
播放爱转了一圈	播放@song
播放爱走了心碎了	播放@song
播放爱最大	播放@song
播放暧昧	播放@song
播放安和桥	播放@song
播放安静	播放@song
播放安妮	播放@song
播放安徒生剧本	播放@song
播放安心的温柔	播放@song
播放暗恋过 结局呢	播放@song
播放暗香	播放@song
播放暗影主宰	播放@song
播放暗涌	播放@song
播放凹凸	播放@song
播放傲寒	播放@song
播放八戒八戒	播放@song
播放八九十	播放@song
播放八年的爱	播放@song
播放八十年代的歌	播放@song
播放巴别塔	播放@song
播放巴黎假期	播放@song
播放巴黎夜雨	播放@song
播放拔萝卜	播放@song
播放把耳朵叫醒	播放@song
播放把酒倒满	播放@song
播放爸爸	播放@song
播放霸气回荡	播放@song
播放霸王别姬	播放@song
播放白鸽	播放@song
播放白狐	播放@song
播放白桦林	播放@song
播放白色恋人	播放@song
播放白芍花开	播放@song
播放白首不相离	播放@song
播放白天不懂夜的黑	播放@song
播放白衣	播放@song
播放百变摇	播放@song
播放百年不合	播放@song
播放百撕不得骑姐	播放@song
播放败将	播放@song
播放拜你所赐	播放@song
播放拜托了	播放@song
播放斑马，斑马	播放@song
播放半包烟	播放@song
播放半点心	播放@song
播放半份关心	播放@song
播放半个地球的挂念	播放@song
播放半壶纱	播放@song
播放半斤八两	播放@song
播放半句承诺	播放@song
播放半路	播放@song
播放半梦半醒忽然之间	播放@song
播放半生时光	播放@song
播放半醒	播放@song
播放伴	播放@song
播放绑架寂寞	播放@song
播放棒棒棒	播放@song
播放包容	播放@song
播放宝贝	播放@song
播放宝贝 你听到了吗	播放@song
播放宝贝别走	播放@song
播放宝贝对不起	播放@song
播放抱抱我好吗	播放@song
播放抱着你的感觉	播放@song
播放暴风雪	播放@song
播放杯水情歌	播放@song
播放悲曲	播放@song
播放悲伤的李白	播放@song
播放悲伤的秋千	播放@song
播放悲伤电影	播放@song
播放悲伤已成曲	播放@song
播放北冰洋之恋	播放@song
播放北国の春	播放@song
播放北极雪	播放@song
播放北京北京	播放@song
播放北京的另一个夜	播放@song
播放北京巷弄	播放@song
播放北京烟火	播放@song
播放北京以北	播放@song
播放贝多芬的忧伤	播放@song
播放贝加尔湖畔	播放@song
播放倍儿爽	播放@song
播放被风吹过的夏天	播放@song
播放被风吹散的人们	播放@song
播放被伤过的心还可以爱谁	播放@song
播放被驯服的象	播放@song
播放被遗忘的时光	播放@song
播放被雨煮过的夏天	播放@song
播放奔跑	播放@song
播放奔跑吧兄弟	播放@song
播放蹦吧啦 Bo Ba La	播放@song
播放蹦沙卡拉卡	播放@song
播放蹦沙卡啦卡 得劲就必摇	播放@song
播放比较美好的世界	播放@song
播放比较喜欢的节奏	播放@song
播放比心更痛的眼眸	播放@song
播放笔记	播放@song
播放毕业后你不是我的	播放@song
播放毕业说分手	播放@song
播放壁虎漫步	播放@song
播放避雨	播放@song
播放边界1999	播放@song
播放变成陌生人	播放@song
播放表	播放@song
播放表白	播放@song
播放表面完美的爱	播放@song
播放别，爱	播放@song
播放别爱	播放@song
播放别爱我	播放@song
播放别把寂寞当缘分	播放@song
播放别把借口当理由	播放@song
播放别把疼你的人弄丢了	播放@song
播放别管那么多	播放@song
播放别靠近	播放@song
播放别哭，我最爱的人	播放@song
播放别哭我最爱的人	播放@song
播放别来无恙	播放@song
播放别怕失去	播放@song
播放别怕我伤心	播放@song
播放别碰我的人	播放@song
播放别让我一个人醉	播放@song
播放别惹哭我	播放@song
播放别人的故事	播放@song
播放别睡了起来嗨	播放@song
播放别说	播放@song
播放别说爱	播放@song
播放别说想我	播放@song
播放别送我	播放@song
播放别忘了	播放@song
播放别问我是谁	播放@song
播放别问我为什么爱你	播放@song
播放别无所求	播放@song
播放别无他求	播放@song
播放别想她	播放@song
播放别用下辈子安慰我	播放@song
播放别再说	播放@song
播放别再说分手	播放@song
播放别在伤口撒盐	播放@song
播放别找我麻烦	播放@song
播放别做我的英雄	播放@song
播放冰封	播放@song
播放冰雪彩虹	播放@song
播放冰雪舞动	播放@song
播放冰雨	播放@song
播放兵兵	播放@song
播放波音循环	播放@song
播放玻璃	播放@song
播放玻璃心	播放@song
播放玻璃之情	播放@song
播放菠萝咒	播放@song
播放不	播放@song
播放不爱的练习	播放@song
播放不爱我放了我	播放@song
播放不爱又何必纠缠	播放@song
播放不必在乎我是谁	播放@song
播放不变	播放@song
播放不变的音乐	播放@song
播放不唱情歌	播放@song
播放不承认还有伤	播放@song
播放不抽烟 不喝酒	播放@song
播放不存在的你	播放@song
播放不搭	播放@song
播放不得不爱	播放@song
播放不分手的恋爱	播放@song
播放不负如来不负卿	播放@song
播放不该相遇在秋天	播放@song
播放不该再是旧的	播放@song
播放不敢说的爱	播放@song
播放不敢听情歌	播放@song
播放不够成熟	播放@song
播放不管有多苦	播放@song
播放不过失去了一点点	播放@song
播放不会发生的故事	播放@song
播放不会痛的不叫爱情	播放@song
播放不会消失的夜晚	播放@song
播放不见不念	播放@song
播放不见长安	播放@song
播放不将就	播放@song
播放不可能的人	播放@song
播放不可说	播放@song
播放不可推搪	播放@song
播放不可小觑	播放@song
播放不客气	播放@song
播放不哭	播放@song
播放不哭了	播放@song
播放不赖	播放@song
播放不浪漫的浪漫	播放@song
播放不浪漫罪名	播放@song
播放不老梦	播放@song
播放不良人	播放@song
播放不明白	播放@song
播放不能承受的感动	播放@song
播放不能跟情人说的话	播放@song
播放不能说出口的诺言	播放@song
播放不能这样活	播放@song
播放不怕痛	播放@song
播放不弃不离	播放@song
播放不让我的眼泪陪我过夜	播放@song
播放不如不见	播放@song
播放不如怀念	播放@song
播放不如听一首歌	播放@song
播放不奢求	播放@song
播放不舍	播放@song
播放不是故意	播放@song
播放不是秘密的秘密	播放@song
播放不是我不爱你	播放@song
播放不是因为寂寞	播放@song
播放不是因为寂寞才想你	播放@song
播放不说再见	播放@song
播放不痛	播放@song
播放不透光	播放@song
播放不完美小孩	播放@song
播放不完整的存在	播放@song
播放不忘初心	播放@song
播放不熄的火花	播放@song
播放不习惯喊痛	播放@song
播放不想懂得	播放@song
播放不想长大	播放@song
播放不想做朋友	播放@song
播放不要就这样离开	播放@song
播放不要认为自己没有用	播放@song
播放不要说话	播放@song
播放不要忘记我爱你	播放@song
播放不要再孤单	播放@song
播放不要在我的伤口撒盐	播放@song
播放不要在我寂寞的时候说爱我	播放@song
播放不应该相信他	播放@song
播放不遇见	播放@song
播放不愿回头	播放@song
播放不再见	播放@song
播放不再联系	播放@song
播放不再犹豫	播放@song
播放不在	播放@song
播放不在乎	播放@song
播放不找了	播放@song
播放不只是朋友	播放@song
播放不知不觉	播放@song
播放不知不觉爱上你	播放@song
播放不醉	播放@song
播放布拉格广场	播放@song
播放步步	播放@song
播放擦肩而过	播放@song
播放猜情人	播放@song
播放才华有限公司	播放@song
播放采茶纪	播放@song
播放采蘑菇的小姑娘	播放@song
播放彩虹	播放@song
播放彩虹的微笑	播放@song
播放彩色的黑	播放@song
播放彩色粉笔	播放@song
播放彩云伴海鸥	播放@song
播放踩踩踩	播放@song
播放残酷游戏	播放@song
播放残酷月光	播放@song
播放残雪	播放@song
播放苍井空	播放@song
播放沧浪之歌	播放@song
播放藏龙卧虎	播放@song
播放曹操	播放@song
播放草原情思	播放@song
播放草原夜色美	播放@song
播放草原一枝花	播放@song
播放草原醉	播放@song
播放策马奔腾	播放@song
播放曾经爱过你	播放@song
播放曾经的你	播放@song
播放曾经的王	播放@song
播放曾经守候	播放@song
播放插曲	播放@song
播放差三岁	播放@song
播放差一点	播放@song
播放钗头凤	播放@song
播放偿还	播放@song
播放嫦娥	播放@song
播放唱给春天的情歌	播放@song
播放唱给你听	播放@song
播放唱给十年后的自己	播放@song
播放唱过什么歌	播放@song
播放唱什么都红不了	播放@song
播放唱我的歌	播放@song
播放超级冠军	播放@song
播放超级英雄	播放@song
播放超可能	播放@song
播放超神的节奏	播放@song
播放超越极限	播放@song
播放朝拜	播放@song
播放潮湿的心	播放@song
播放吵架歌	播放@song
播放车载3D酒吧摇	播放@song
播放车站	播放@song
播放彻彻底底忘记你	播放@song
播放尘埃	播放@song
播放尘缘	播放@song
播放沉默的羔羊	播放@song
播放沉默是金	播放@song
播放趁你还爱趁他还在	播放@song
播放趁早	播放@song
播放成都	播放@song
播放成全	播放@song
播放承诺	播放@song
播放承认	播放@song
播放城	播放@song
播放城府	播放@song
播放城里的月光	播放@song
播放城市的天空	播放@song
播放乘风破浪歌	播放@song
播放橙花	播放@song
播放痴痴地把你等待	播放@song
播放痴心绝对	播放@song
播放迟到的歌	播放@song
播放迟来的爱	播放@song
播放赤裸裸的离开	播放@song
播放炽热的青春	播放@song
播放冲动	播放@song
播放冲动的惩罚	播放@song
播放冲破	播放@song
播放虫儿飞	播放@song
播放宠爱	播放@song
播放抽离	播放@song
播放丑八怪	播放@song
播放出发爱情	播放@song
播放出界	播放@song
播放出卖	播放@song
播放出卖我	播放@song
播放初爱	播放@song
播放初学者	播放@song
播放处处吻	播放@song
播放触动心触动爱	播放@song
播放触碰不到的痛	播放@song
播放触碰纯白	播放@song
播放穿过你的黑发的我的手	播放@song
播放穿过前男友胸前的箭	播放@song
播放穿越火线	播放@song
播放穿越漩涡	播放@song
播放穿着西服喊另类	播放@song
播放传奇	播放@song
播放传闻	播放@song
播放船	播放@song
播放船子	播放@song
播放喘息	播放@song
播放窗台	播放@song
播放窗外	播放@song
播放床前明月光	播放@song
播放吹眼睛	播放@song
播放炊烟	播放@song
播放春风吹醒我的爱	播放@song
播放春风十里	播放@song
播放春风他吻上了我的脸	播放@song
播放春花秋月	播放@song
播放春泥	播放@song
播放春暖花开	播放@song
播放春天里	播放@song
播放春夏秋冬	播放@song
播放纯属意外	播放@song
播放纯真年代	播放@song
播放词不达意	播放@song
播放刺猬的拥抱	播放@song
播放匆匆	播放@song
播放匆匆那年	播放@song
播放从爱发落	播放@song
播放从此以后	播放@song
播放从此以后一个人	播放@song
播放从开始到结束	播放@song
播放从开始到现在	播放@song
播放从来没有忘记过	播放@song
播放从你的全世界路过	播放@song
播放从前的我	播放@song
播放从头再来	播放@song
播放从未到过的地方	播放@song
播放从未这样心动过	播放@song
播放从醒着到愿意睡着	播放@song
播放存在	播放@song
播放存在感	播放@song
播放寸缕	播放@song
播放错爱	播放@song
播放错错错	播放@song
播放错的人	播放@song
播放错怪	播放@song
播放错过	播放@song
播放错过的牵手	播放@song
播放错过了	播放@song
播放错是你痛是我	播放@song
播放错位节拍	播放@song
播放妲己	播放@song
播放答案	播放@song
播放答应不爱你	播放@song
播放打呼	播放@song
播放打屁	播放@song
播放打扰爱情	播放@song
播放大悲咒	播放@song
播放大啵女郎	播放@song
播放大城大事	播放@song
播放大城小爱	播放@song
播放大地	播放@song
播放大哥	播放@song
播放大国民	播放@song
播放大过天	播放@song
播放大海	播放@song
播放大火	播放@song
播放大家一起喜羊羊	播放@song
播放大浪漫主义	播放@song
播放大龄女子	播放@song
播放大梦想家	播放@song
播放大漠英雄	播放@song
播放大脑摘除后	播放@song
播放大女人	播放@song
播放大人情歌	播放@song
播放大舌头	播放@song
播放大唐荣耀	播放@song
播放大王叫我来巡山	播放@song
播放大西厢	播放@song
播放大小姐	播放@song
播放大笑江湖	播放@song
播放大爷	播放@song
播放大一	播放@song
播放大艺术家	播放@song
播放大鱼	播放@song
播放大雨将至	播放@song
播放大约在冬季	播放@song
播放大众空间麦	播放@song
播放带泪的鱼	播放@song
播放带你走	播放@song
播放带上月光上路	播放@song
播放带我到山顶	播放@song
播放带我走	播放@song
播放带着天真去流浪	播放@song
播放待我百万人气	播放@song
播放戴着面具的女郎	播放@song
播放单车恋人	播放@song
播放单程	播放@song
播放单行的轨道	播放@song
播放单恋一枝花	播放@song
播放单曲循环	播放@song
播放单色戒指	播放@song
播放单身歌	播放@song
播放单身美好	播放@song
播放单身情歌	播放@song
播放单眼皮女生	播放@song
播放胆小鬼	播放@song
播放但愿人长久	播放@song
播放淡淡的歌	播放@song
播放弹跳震感	播放@song
播放弹指一挥间	播放@song
播放当爱靠近	播放@song
播放当爱来敲门	播放@song
播放当爱已成往事	播放@song
播放当爱在靠近	播放@song
播放当兵的哥们最气派	播放@song
播放当兵就是爽	播放@song
播放当冬夜渐暖	播放@song
播放当你	播放@song
播放当你老了	播放@song
播放当你听我说	播放@song
播放当你要离开的时候	播放@song
播放当年情	播放@song
播放当世界安静	播放@song
播放当我唱起这首歌	播放@song
播放当我孤独的时候还可以抱着你	播放@song
播放当我们	播放@song
播放当我想你的时候	播放@song
播放当我找到了你	播放@song
播放当我知道你们相爱	播放@song
播放荡漾	播放@song
播放刀光剑影	播放@song
播放刀剑如梦	播放@song
播放刀怒斩逆徒	播放@song
播放刀山火海	播放@song
播放倒带	播放@song
播放倒转人生	播放@song
播放到不了	播放@song
播放稻香	播放@song
播放灯塔	播放@song
播放等	播放@song
播放等爱	播放@song
播放等爱的新娘	播放@song
播放等不到的爱	播放@song
播放等不到的期待	播放@song
播放等不起的爱	播放@song
播放等待	播放@song
播放等到来生再相遇	播放@song
播放等风	播放@song
播放等风来	播放@song
播放等风也等你	播放@song
播放等了又等	播放@song
播放等你	播放@song
播放等你爱我	播放@song
播放等你等到我心痛	播放@song
播放等你等了那么久	播放@song
播放等一分钟	播放@song
播放等一个晴天	播放@song
播放滴答	播放@song
播放地动山摇	播放@song
播放地图	播放@song
播放帝都	播放@song
播放第几次离开我	播放@song
播放第七感	播放@song
播放第三极	播放@song
播放第三人称	播放@song
播放第三十八年夏至	播放@song
播放第三者的第三者	播放@song
播放第十一年	播放@song
播放第一次	播放@song
播放第一课	播放@song
播放点水	播放@song
播放电的不要不要的	播放@song
播放电话皇后	播放@song
播放电台情歌	播放@song
播放电音之王	播放@song
播放店小二	播放@song
播放雕琢	播放@song
播放屌丝之歌	播放@song
播放蝶	播放@song
播放蝶恋妃	播放@song
播放蝶恋花	播放@song
播放蝶缘	播放@song
播放丁香花	播放@song
播放定西	播放@song
播放丢都丢了.别再哭了	播放@song
播放东北话	播放@song
播放东北人	播放@song
播放东北味儿	播放@song
播放东北兄弟	播放@song
播放东方之珠	播放@song
播放东风志	播放@song
播放东京不太热	播放@song
播放冬季到台北来看雨	播放@song
播放冬天的秘密	播放@song
播放冬天里的一把火	播放@song
播放董小姐	播放@song
播放动了情的痞子	播放@song
播放动物森林	播放@song
播放动心	播放@song
播放冻结	播放@song
播放都是你的错	播放@song
播放都是夜归人	播放@song
播放都要好好的	播放@song
播放兜里缺点钱	播放@song
播放嘟比嘟	播放@song
播放毒后	播放@song
播放独家记忆	播放@song
播放独家试唱	播放@song
播放独角戏	播放@song
播放独一无二	播放@song
播放独照	播放@song
播放杜十娘	播放@song
播放渡风	播放@song
播放渡红尘	播放@song
播放渡情	播放@song
播放渡人	播放@song
播放短发	播放@song
播放断点	播放@song
播放断绝来往	播放@song
播放断了的弦	播放@song
播放断了乱了	播放@song
播放断桥残雪	播放@song
播放断情笔	播放@song
播放对不起	播放@song
播放对不起，我还爱你	播放@song
播放对不起我爱你	播放@song
播放对不起我还爱你	播放@song
播放对面的女孩看过来	播放@song
播放对你做过的事	播放@song
播放对嘴	播放@song
播放多莉宝贝	播放@song
播放多难	播放@song
播放多瑙河畔	播放@song
播放多年后	播放@song
播放多年以后	播放@song
播放多情的人总被无情的伤	播放@song
播放多情的我遇上绝情的你	播放@song
播放多情人把灵魂都给了谁	播放@song
播放多情人都把灵魂给了谁	播放@song
播放多情总为无情伤	播放@song
播放多喜欢你	播放@song
播放多想把你抱住	播放@song
播放多想抓住你冰冷的手	播放@song
播放多想做你最爱的人	播放@song
播放多幸运	播放@song
播放多余的关心	播放@song
播放多余的解释	播放@song
播放多远都要在一起	播放@song
播放多远也要在一起	播放@song
播放堕落天使	播放@song
播放额尔古纳	播放@song
播放恶人	播放@song
播放饿狼传说	播放@song
播放二话西游	播放@song
播放二十岁的某一天	播放@song
播放发如雪	播放@song
播放发小	播放@song
播放凡人歌	播放@song
播放繁星	播放@song
播放反话	播放@song
播放反派	播放@song
播放梵高先生	播放@song
播放芳华绝代	播放@song
播放房间	播放@song
播放放不过自己	播放@song
播放放不下	播放@song
播放放不下的守候	播放@song
播放放不下他	播放@song
播放放过自己	播放@song
播放放开爱	播放@song
播放放开那三国	播放@song
播放放开你的头脑	播放@song
播放放了手就忘了我	播放@song
播放放你在心里	播放@song
播放放弃	播放@song
播放放弃我 抓紧我	播放@song
播放放手	播放@song
播放放手的勇气	播放@song
播放放手了吗	播放@song
播放放手去爱	播放@song
播放放下	播放@song
播放放下难舍的缘	播放@song
播放放下所有放不下你	播放@song
播放放心不下	播放@song
播放放心去飞	播放@song
播放飞得更高	播放@song
播放飞鸟	播放@song
播放飞女正传	播放@song
播放飞向更远的地方	播放@song
播放飞在风中的小雨	播放@song
播放飞走了	播放@song
播放非常爱你	播放@song
播放非你不爱	播放@song
播放非你不可	播放@song
播放非正常励志歌	播放@song
播放分分合合	播放@song
播放分开旅行	播放@song
播放分开那天	播放@song
播放分手的理由	播放@song
播放分手的拥抱	播放@song
播放分手后还是朋友	播放@song
播放分手以后	播放@song
播放分手在那个秋天	播放@song
播放分手做朋友	播放@song
播放焚情	播放@song
播放奋不顾身	播放@song
播放风吹麦浪	播放@song
播放风的季节	播放@song
播放风的尽头	播放@song
播放风的终点	播放@song
播放风度	播放@song
播放风飞沙	播放@song
播放风华燃尽-指间砂	播放@song
播放风继续吹	播放@song
播放风起时	播放@song
播放风起时，想你	播放@song
播放风起天阑	播放@song
播放风沙	播放@song
播放风往北吹	播放@song
播放风月	播放@song
播放风云	播放@song
播放风再起时	播放@song
播放风筝	播放@song
播放风筝误	播放@song
播放风筝与风	播放@song
播放风之恋	播放@song
播放风中的承诺	播放@song
播放风中少年	播放@song
播放风中有朵雨做的云	播放@song
播放封面恋人	播放@song
播放疯狂爱	播放@song
播放疯人愿	播放@song
播放锋味	播放@song
播放凤凰飞	播放@song
播放凤凰花开的路口	播放@song
播放凤凰劫	播放@song
播放芙蓉雨	播放@song
播放浮夸	播放@song
播放浮生辞	播放@song
播放浮生尽	播放@song
播放浮生未歇	播放@song
播放蜉蝣	播放@song
播放福尔马林	播放@song
播放腐草为萤	播放@song
播放父亲	播放@song
播放父子	播放@song
播放负心人	播放@song
播放复活	播放@song
播放复刻回忆	播放@song
播放伽蓝圣众菩萨	播放@song
播放该放手了	播放@song
播放该死的温柔	播放@song
播放该死的异地恋	播放@song
播放该怎么过	播放@song
播放改变自己	播放@song
播放甘心情愿爱着你	播放@song
播放甘心替代你	播放@song
播放敢 Roleplay	播放@song
播放敢不敢爱	播放@song
播放敢伤	播放@song
播放敢问路在何方	播放@song
播放感恩的心	播放@song
播放感情套路深	播放@song
播放感受吧我的风格	播放@song
播放感同身受	播放@song
播放感谢	播放@song
播放感谢苦难	播放@song
播放感谢有你相伴	播放@song
播放干物女	播放@song
播放刚刚好	播放@song
播放刚好遇见你	播放@song
播放钢铁是眼泪炼成的	播放@song
播放高手	播放@song
播放高原蓝	播放@song
播放搞笑	播放@song
播放告白	播放@song
播放告白气球	播放@song
播放告别我	播放@song
播放告别之前	播放@song
播放告诉你这才是社会摇	播放@song
播放告诉他	播放@song
播放告诉自己忘了他	播放@song
播放哥哥	播放@song
播放哥哥妹妹	播放@song
播放哥妹情缘	播放@song
播放鸽子	播放@song
播放歌路	播放@song
播放歌曲串烧	播放@song
播放歌未央	播放@song
播放歌在飞	播放@song
播放格斗场	播放@song
播放给你	播放@song
播放给你们	播放@song
播放给十年后的我	播放@song
播放给我的快乐	播放@song
播放给我个忘记你的理由	播放@song
播放给我一个理由忘记	播放@song
播放给我一首歌的时间	播放@song
播放给自己	播放@song
播放给自己的歌	播放@song
播放跟往事干杯	播放@song
播放跟着感觉走	播放@song
播放耿耿星河	播放@song
播放耿耿于怀	播放@song
播放更好的以后	播放@song
播放工体爱情故事	播放@song
播放公主范	播放@song
播放公主梦	播放@song
播放功夫瑜伽	播放@song
播放恭喜发财	播放@song
播放恭喜呀恭喜	播放@song
播放共你痴痴爱在	播放@song
播放共同度过	播放@song
播放共同渡过	播放@song
播放共邀一场春暖花开	播放@song
播放狗日的青春	播放@song
播放够钟	播放@song
播放咕咕	播放@song
播放咕叽咕叽	播放@song
播放孤爱	播放@song
播放孤单背影	播放@song
播放孤单坠爱	播放@song
播放孤独的鸟	播放@song
播放孤独的遗憾	播放@song
播放孤独患者	播放@song
播放孤独烈酒	播放@song
播放孤芳不自赏	播放@song
播放孤鸟的歌	播放@song
播放孤身走我路	播放@song
播放姑苏慕容	播放@song
播放骨子里的我	播放@song
播放鼓与花	播放@song
播放固执	播放@song
播放故城	播放@song
播放故梦	播放@song
播放故人叹	播放@song
播放故事1983	播放@song
播放故乡	播放@song
播放故意	播放@song
播放故意不爱你	播放@song
播放挂彩	播放@song
播放乖乖	播放@song
播放怪你过分美丽	播放@song
播放怪胎	播放@song
播放关不掉的月光	播放@song
播放关不上的窗	播放@song
播放关忆北	播放@song
播放关于	播放@song
播放关于你的故事	播放@song
播放关于你的我	播放@song
播放关于我们	播放@song
播放关于郑州的记忆	播放@song
播放观众	播放@song
播放棺木	播放@song
播放管他什么音乐	播放@song
播放惯性恋	播放@song
播放光	播放@song
播放光彩第二街	播放@song
播放光棍	播放@song
播放光辉岁月	播放@song
播放光明	播放@song
播放光年之外	播放@song
播放光阴的故事	播放@song
播放光着我的脚丫子	播放@song
播放广岛之恋	播放@song
播放逛吃逛吃	播放@song
播放归	播放@song
播放归来吧	播放@song
播放归零	播放@song
播放闺蜜蜜	播放@song
播放诡爱	播放@song
播放鬼迷心窍	播放@song
播放滚	播放@song
播放滚出我心底	播放@song
播放滚滚红尘	播放@song
播放国家	播放@song
播放国王与乞丐	播放@song
播放过得比我好	播放@song
播放过儿	播放@song
播放过火	播放@song
播放过客	播放@song
播放过年味儿	播放@song
播放过期爱情	播放@song
播放过期荷尔蒙	播放@song
播放过去了	播放@song
播放哈尼，你最重要	播放@song
播放哈你歌	播放@song
播放还好吗	播放@song
播放还好有你在	播放@song
播放还魂门	播放@song
播放还记得	播放@song
播放还没见面就分手	播放@song
播放还能孩子多久	播放@song
播放还是好朋友	播放@song
播放还是那个你	播放@song
播放还是朋友	播放@song
播放还要	播放@song
播放还有我	播放@song
播放还原爱情	播放@song
播放还在这里	播放@song
播放孩子	播放@song
播放海阔天空	播放@song
播放海绵宝宝	播放@song
播放海沙画	播放@song
播放海上的月亮	播放@song
播放海市蜃楼	播放@song
播放海誓山盟亦会分开	播放@song
播放海棠花开	播放@song
播放海啸	播放@song
播放害怕	播放@song
播放寒冬	播放@song
播放寒衣调	播放@song
播放喊遍整个东三省	播放@song
播放行歌	播放@song
播放行者	播放@song
播放行走的力量	播放@song
播放好爱好散	播放@song
播放好姑娘	播放@song
播放好好	播放@song
播放好好地	播放@song
播放好好说再见	播放@song
播放好姐妹	播放@song
播放好久不见	播放@song
播放好可惜	播放@song
播放好了伤疤忘了痛	播放@song
播放好男儿	播放@song
播放好男人	播放@song
播放好女孩	播放@song
播放好朋友只是朋友	播放@song
播放好人好梦	播放@song
播放好人就在身边	播放@song
播放好时辰	播放@song
播放好时光	播放@song
播放好听	播放@song
播放好想抱着你	播放@song
播放好想你	播放@song
播放好想谈恋爱	播放@song
播放好心分手	播放@song
播放好兄弟	播放@song
播放浩悦爱情	播放@song
播放喝彩	播放@song
播放喝汤	播放@song
播放喝下你藏好的毒	播放@song
播放喝醉以后我想你	播放@song
播放何必怀念	播放@song
播放何必执着一张脸	播放@song
播放何时才能让你说爱我	播放@song
播放何时了却这牵挂	播放@song
播放和从前一样	播放@song
播放和你一样	播放@song
播放和你在一起	播放@song
播放和平之光	播放@song
播放和天一样高	播放@song
播放河流	播放@song
播放河流.午后.我经过	播放@song
播放荷塘月色	播放@song
播放黑	播放@song
播放黑暗萝莉	播放@song
播放黑暗骑士	播放@song
播放黑白小巷	播放@song
播放黑板情书	播放@song
播放黑道风云	播放@song
播放黑框眼镜	播放@song
播放黑裙子	播放@song
播放黑色柳丁	播放@song
播放黑色毛衣	播放@song
播放黑天鹅	播放@song
播放嘿,裤衩儿	播放@song
播放嘿，抬头！	播放@song
播放嘿嘿嘿	播放@song
播放很爱很爱的	播放@song
播放很爱很爱你	播放@song
播放很爱你	播放@song
播放很奇怪我爱你	播放@song
播放很想对你说	播放@song
播放很想很想说再见	播放@song
播放狠心拆穿	播放@song
播放横冲直撞	播放@song
播放红遍全球	播放@song
播放红尘	播放@song
播放红尘蝶恋	播放@song
播放红尘劫	播放@song
播放红尘客栈	播放@song
播放红尘情歌	播放@song
播放红尘私语	播放@song
播放红尘叹	播放@song
播放红尘有你	播放@song
播放红尘有缘	播放@song
播放红当当飞吻	播放@song
播放红豆	播放@song
播放红梅主题随想曲	播放@song
播放红蜻蜓	播放@song
播放红日	播放@song
播放红色高跟鞋	播放@song
播放红颜	播放@song
播放红颜劫	播放@song
播放红颜旧	播放@song
播放红颜若雪	播放@song
播放红衣	播放@song
播放红雨	播放@song
播放红装	播放@song
播放虹之间	播放@song
播放鸿雁	播放@song
播放后悔	播放@song
播放后会无期	播放@song
播放后继者	播放@song
播放后来	播放@song
播放后来的我们	播放@song
播放呼唤	播放@song
播放呼伦贝尔大草原	播放@song
播放呼啸而过	播放@song
播放忽然	播放@song
播放忽然好想念	播放@song
播放忽然之间	播放@song
播放狐言	播放@song
播放胡歌	播放@song
播放胡撸胡撸瓢儿	播放@song
播放胡闹	播放@song
播放湖光水色调	播放@song
播放蝴蝶飞呀	播放@song
播放虎口脱险	播放@song
播放护花使者	播放@song
播放花店	播放@song
播放花都	播放@song
播放花儿 + 静止	播放@song
播放花儿与少年	播放@song
播放花房姑娘	播放@song
播放花花宇宙	播放@song
播放花火	播放@song
播放花笺	播放@song
播放花开繁华	播放@song
播放花开那年	播放@song
播放花千骨	播放@song
播放花千骨她泪三尺	播放@song
播放花水月	播放@song
播放花下舞剑	播放@song
播放花样年华	播放@song
播放划地为牢	播放@song
播放华胥引	播放@song
播放化身孤岛的鲸	播放@song
播放画	播放@song
播放画风	播放@song
播放画情	播放@song
播放画心	播放@song
播放画颜	播放@song
播放画中仙	播放@song
播放坏女孩	播放@song
播放欢快的节奏咱就得摇	播放@song
播放欢乐颂	播放@song
播放欢乐夜	播放@song
播放环城巴士	播放@song
播放幻觉	播放@song
播放幻梦	播放@song
播放幻听	播放@song
播放幻雨	播放@song
播放皇帝	播放@song
播放皇冠	播放@song
播放皇后大道东	播放@song
播放黄昏	播放@song
播放黄玫瑰	播放@song
播放黄色枫叶	播放@song
播放黄种人	播放@song
播放灰色轨迹	播放@song
播放灰色头像	播放@song
播放挥别昨天的我	播放@song
播放挥着翅膀的女孩	播放@song
播放回不去了	播放@song
播放回不去了吗	播放@song
播放回电我	播放@song
播放回甘	播放@song
播放回家吃饭	播放@song
播放回家的路	播放@song
播放回了又去，去了再回	播放@song
播放回眸一笑	播放@song
播放回声	播放@song
播放回味	播放@song
播放回心转意	播放@song
播放回忆的代价	播放@song
播放回忆里的疯狂	播放@song
播放回忆里的那个人	播放@song
播放毁灭性硬妹子	播放@song
播放会飞的贼	播放@song
播放会过去的	播放@song
播放会哭的人不一定流泪	播放@song
播放会受伤的人只有一种可能	播放@song
播放会痛的石头	播放@song
播放活该	播放@song
播放活着	播放@song
播放活着Viva	播放@song
播放火	播放@song
播放火柴天堂	播放@song
播放火车经过海棠	播放@song
播放火车开往落日	播放@song
播放火红的太阳	播放@song
播放火花	播放@song
播放火火火火火曲	播放@song
播放火辣辣的情歌	播放@song
播放火鸟	播放@song
播放火山	播放@song
播放火星人来过	播放@song
播放伙伴歌	播放@song
播放鸡叫过大年	播放@song
播放激情	播放@song
播放吉拉拉	播放@song
播放吉姆餐厅	播放@song
播放极品神鼓	播放@song
播放即刻出发	播放@song
播放即客	播放@song
播放即使说抱歉	播放@song
播放極楽浄土	播放@song
播放几分伤心几分痴	播放@song
播放几年了	播放@song
播放记得	播放@song
播放记得那一年	播放@song
播放记得我爱你	播放@song
播放记事本	播放@song
播放记忆的味蕾	播放@song
播放继续-给十五岁的自己	播放@song
播放寄生	播放@song
播放寂寞的季节	播放@song
播放寂寞的人伤心的歌	播放@song
播放寂寞的游鱼	播放@song
播放寂寞寂寞就好	播放@song
播放寂寞咖啡	播放@song
播放寂寞来了怎么办	播放@song
播放寂寞来袭	播放@song
播放寂寞沙洲冷	播放@song
播放寂寞是因为思念谁	播放@song
播放寂寞先生	播放@song
播放寂寞有多长	播放@song
播放寂夜	播放@song
播放霁夜茶	播放@song
播放加勒比海盗	播放@song
播放家	播放@song
播放家的味道	播放@song
播放家驹	播放@song
播放家在东北	播放@song
播放假行僧	播放@song
播放假面	播放@song
播放假如	播放@song
播放假如爱有天意	播放@song
播放假如让我说下去	播放@song
播放假如有一天	播放@song
播放假装淡定	播放@song
播放坚持到底	播放@song
播放坚强	播放@song
播放肩上蝶	播放@song
播放肩上蜻蜓	播放@song
播放煎熬	播放@song
播放剪断	播放@song
播放简单爱	播放@song
播放简讯	播放@song
播放见习爱神	播放@song
播放见与不见	播放@song
播放建筑师的梦想	播放@song
播放剑伤	播放@song
播放剑侠情缘	播放@song
播放剑心	播放@song
播放健康动起来	播放@song
播放健忘	播放@song
播放江湖大道	播放@song
播放江南	播放@song
播放江南Style	播放@song
播放江山	播放@song
播放江山背后	播放@song
播放江山如梦	播放@song
播放江山无限	播放@song
播放将军令	播放@song
播放将军与妓	播放@song
播放僵尸 Zombie	播放@song
播放讲不出再见	播放@song
播放降临	播放@song
播放骄傲的少年	播放@song
播放叫你一声My Love	播放@song
播放叫醒冬天	播放@song
播放较量	播放@song
播放皆非	播放@song
播放街道商场公共场所禁播	播放@song
播放街灯晚餐	播放@song
播放街角的祝福	播放@song
播放劫后余生	播放@song
播放杰出星空	播放@song
播放结	播放@song
播放结婚	播放@song
播放结束	播放@song
播放姐姐	播放@song
播放姐妹们的聚会	播放@song
播放解开魔咒	播放@song
播放解脱	播放@song
播放解药	播放@song
播放戒爱	播放@song
播放戒不掉的爱	播放@song
播放戒情人	播放@song
播放借过	播放@song
播放借口	播放@song
播放借他一个明天	播放@song
播放借我一生	播放@song
播放今生爱的就是你	播放@song
播放今生爱上你	播放@song
播放今生不变的爱恋	播放@song
播放今生梦牵	播放@song
播放今生你作伴	播放@song
播放今生陪你一起走	播放@song
播放今生无缘来生再聚	播放@song
播放今世有缘	播放@song
播放今天	播放@song
播放今天的我们	播放@song
播放今天你嗨了么	播放@song
播放今天你要嫁给我	播放@song
播放今晚的月亮	播放@song
播放今宵多珍重	播放@song
播放今夜你会不会来	播放@song
播放今夜我对你想入非非	播放@song
播放今夜烟花灿烂	播放@song
播放金苹果	播放@song
播放金钱社会	播放@song
播放金玉良缘	播放@song
播放矜持	播放@song
播放锦鲤抄	播放@song
播放锦绣未央	播放@song
播放进退两难	播放@song
播放近在千里	播放@song
播放劲歌金曲	播放@song
播放经过	播放@song
播放惊鸿舞	播放@song
播放惊鸿一面	播放@song
播放惊雷	播放@song
播放惊声尖叫	播放@song
播放惊天动地	播放@song
播放精舞门	播放@song
播放精忠报国	播放@song
播放精忠传奇	播放@song
播放鲸城	播放@song
播放颈上胭脂红	播放@song
播放静静的	播放@song
播放镜花水月	播放@song
播放镜子里的我	播放@song
播放纠缠	播放@song
播放九儿	播放@song
播放九九八十一	播放@song
播放九九艳阳天	播放@song
播放九世轮回篇	播放@song
播放九世轮回篇空拍	播放@song
播放九阴真经	播放@song
播放九月爱情海	播放@song
播放九月鹰飞	播放@song
播放玖月奇迹	播放@song
播放玖月情歌	播放@song
播放酒吧主打女榜	播放@song
播放酒干倘卖无	播放@song
播放旧红颜	播放@song
播放咎由自取	播放@song
播放就此别过	播放@song
播放就决定是你了！	播放@song
播放就是爱你	播放@song
播放就是现在	播放@song
播放就是想着你	播放@song
播放就说我们都是华丽的单身族	播放@song
播放就算世界无童话	播放@song
播放就算是吧	播放@song
播放就因为	播放@song
播放就在不远的2013年	播放@song
播放就这个调调	播放@song
播放就这样吗	播放@song
播放菊花爆满山	播放@song
播放橘子汽水	播放@song
播放举起你的双手	播放@song
播放巨人的肩膀	播放@song
播放距离	播放@song
播放聚散	播放@song
播放卷珠帘	播放@song
播放眷恋	播放@song
播放决绝	播放@song
播放绝地逃亡	播放@song
播放绝口不提！爱你	播放@song
播放绝恋	播放@song
播放倔强	播放@song
播放君临天下	播放@song
播放喀什噶尔胡杨	播放@song
播放卡比巴拉的海	播放@song
播放卡西莫多的礼物	播放@song
播放开放	播放@song
播放开门见山	播放@song
播放开始	播放@song
播放开始懂了	播放@song
播放开始最冷的风	播放@song
播放看不清的爱	播放@song
播放看过来	播放@song
播放看见	播放@song
播放看看	播放@song
播放看了又看	播放@song
播放看你往哪跑	播放@song
播放看上她	播放@song
播放看我72变	播放@song
播放看月亮爬上来	播放@song
播放看走眼	播放@song
播放康定情歌	播放@song
播放康定情歌与溜溜调	播放@song
播放康美之恋	播放@song
播放可爱	播放@song
播放可爱女人	播放@song
播放可不可以爱	播放@song
播放可不可以不勇敢	播放@song
播放可乐	播放@song
播放可惜	播放@song
播放可惜不是你	播放@song
播放可惜不是你陪我看彩虹	播放@song
播放可惜没如果	播放@song
播放可惜我是水瓶座	播放@song
播放可以的话	播放@song
播放可以了	播放@song
播放渴死的鱼	播放@song
播放克卜勒	播放@song
播放空白格	播放@song
播放空白世界	播放@song
播放空城	播放@song
播放空虚，沸腾	播放@song
播放孔雀东南飞	播放@song
播放口是心非	播放@song
播放哭了	播放@song
播放哭砂	播放@song
播放苦笑	播放@song
播放酷	播放@song
播放酷爱	播放@song
播放酷跑 Run For More	播放@song
播放快活	播放@song
播放快乐宝贝	播放@song
播放快乐崇拜	播放@song
播放快乐的等待	播放@song
播放快乐老实人	播放@song
播放快乐嘭恰恰	播放@song
播放快乐颂	播放@song
播放快乐星猫	播放@song
播放快乐有你	播放@song
播放快让我在雪地上撒点野	播放@song
播放快让我在这雪地上撒点野	播放@song
播放快手社会摇7妹改	播放@song
播放宽容	播放@song
播放狂风里拥抱	播放@song
播放狂人派对	播放@song
播放拉萨羌沙	播放@song
播放来吧！冠军	播放@song
播放来日方长	播放@song
播放来生	播放@song
播放来生舞	播放@song
播放来生缘	播放@song
播放来生愿做一朵莲	播放@song
播放来信	播放@song
播放来自你.来自我.来自他	播放@song
播放来自星星的你	播放@song
播放兰花指	播放@song
播放兰铃曲	播放@song
播放蓝莲花	播放@song
播放蓝色骨头	播放@song
播放蓝色土耳其	播放@song
播放蓝色雨	播放@song
播放蓝瘦香菇	播放@song
播放啷个哩个啷	播放@song
播放郎的诱惑	播放@song
播放狼	播放@song
播放浪费	播放@song
播放浪花一朵朵	播放@song
播放浪漫来袭	播放@song
播放浪子心声	播放@song
播放浪子醉酒没有她	播放@song
播放老北京变了	播放@song
播放老唱盘	播放@song
播放老大	播放@song
播放老地方	播放@song
播放老地方的雨	播放@song
播放老公PK老婆	播放@song
播放老虎油	播放@song
播放老街	播放@song
播放老九门	播放@song
播放老男孩	播放@song
播放老朋友	播放@song
播放老婆	播放@song
播放老婆老婆你要乖	播放@song
播放老婆你辛苦了	播放@song
播放老齐	播放@song
播放老人与海	播放@song
播放老人与少年	播放@song
播放老神仙	播放@song
播放老屋	播放@song
播放老友记	播放@song
播放乐观	播放@song
播放泪点	播放@song
播放泪光闪烁	播放@song
播放泪海	播放@song
播放泪满天	播放@song
播放泪三年	播放@song
播放泪雨红妆	播放@song
播放泪妆	播放@song
播放类似爱情	播放@song
播放累了走了散了	播放@song
播放冷暴力	播放@song
播放冷风里	播放@song
播放冷酷到底	播放@song
播放冷冷再见	播放@song
播放冷雨夜	播放@song
播放离爱不远	播放@song
播放离别	播放@song
播放离别的车站	播放@song
播放离别的秋天	播放@song
播放离不开你	播放@song
播放离场	播放@song
播放离歌	播放@song
播放离开	播放@song
播放离开北京	播放@song
播放离开的理由	播放@song
播放离开地球表面	播放@song
播放离开了我过的好不好	播放@song
播放离开为了更好的回来	播放@song
播放离开我的自由	播放@song
播放离人	播放@song
播放骊歌	播放@song
播放梨花又开放	播放@song
播放礼物	播放@song
播放李	播放@song
播放李白	播放@song
播放李雷和韩梅梅	播放@song
播放理想	播放@song
播放理想三旬	播放@song
播放理智与感情	播放@song
播放历历万乡	播放@song
播放厉害了！我的歌	播放@song
播放厉害了word哥	播放@song
播放莉莉安	播放@song
播放连借口都没有	播放@song
播放连衣裙	播放@song
播放莲花	播放@song
播放涟漪	播放@song
播放练习	播放@song
播放炼爱	播放@song
播放恋爱达人	播放@song
播放恋爱大过天	播放@song
播放恋爱过那么结局呢	播放@song
播放恋恋风尘	播放@song
播放恋曲1980	播放@song
播放恋曲1990	播放@song
播放恋人歌歌	播放@song
播放恋人未满	播放@song
播放恋人心	播放@song
播放恋上外星人	播放@song
播放恋香	播放@song
播放恋着你的影子	播放@song
播放凉城	播放@song
播放凉凉	播放@song
播放梁祝	播放@song
播放两地情缘	播放@song
播放两个男人的周末	播放@song
播放两个人的回忆一个人过	播放@song
播放两个人的烟火	播放@song
播放两根筷子	播放@song
播放两颗心四行泪	播放@song
播放两人行	播放@song
播放两双	播放@song
播放两小无猜	播放@song
播放两者之间	播放@song
播放两只蝴蝶	播放@song
播放两只老虎	播放@song
播放两只小蜜蜂	播放@song
播放聊聊	播放@song
播放列王的纷争	播放@song
播放烈火神盾	播放@song
播放烈女	播放@song
播放邻家美眉	播放@song
播放林中鸟	播放@song
播放临安初雨	播放@song
播放临时演员	播放@song
播放淋雨一直走	播放@song
播放灵魂尽头	播放@song
播放凌乱的华丽	播放@song
播放聆听者	播放@song
播放领悟	播放@song
播放另类雇佣兵	播放@song
播放另一个北京	播放@song
播放另一个孤独的歌者	播放@song
播放另一个自己	播放@song
播放刘稳妥	播放@song
播放留不低	播放@song
播放留不住的故事	播放@song
播放留不住你的人	播放@song
播放留什么给你	播放@song
播放留香	播放@song
播放流浪	播放@song
播放流浪的牧马人	播放@song
播放流浪歌手的情人	播放@song
播放流浪记	播放@song
播放流恋	播放@song
播放流年	播放@song
播放流沙	播放@song
播放流星雨	播放@song
播放流着泪说分手	播放@song
播放琉璃月	播放@song
播放六层楼	播放@song
播放六日战士	播放@song
播放六神无主	播放@song
播放六字真言颂	播放@song
播放龙卷风	播放@song
播放泸沽寻梦	播放@song
播放鲁冰花	播放@song
播放鹿港小镇	播放@song
播放路	播放@song
播放路灯下的小姑娘	播放@song
播放路过幸福	播放@song
播放路太弯	播放@song
播放路一直都在	播放@song
播放乱炖的木吉他	播放@song
播放乱世	播放@song
播放乱世巨星	播放@song
播放乱世殇	播放@song
播放乱世月光	播放@song
播放螺旋大锯，嗨的你找不见方向	播放@song
播放裸夏	播放@song
播放洛丽塔	播放@song
播放落花	播放@song
播放落花雨	播放@song
播放落空	播放@song
播放落梅笺	播放@song
播放落日谣	播放@song
播放落俗	播放@song
播放落叶情	播放@song
播放旅程	播放@song
播放旅行	播放@song
播放绿光	播放@song
播放绿旋风	播放@song
播放略略略	播放@song
播放妈妈	播放@song
播放妈说	播放@song
播放麻花辫子	播放@song
播放麻辣火歌	播放@song
播放玛利亚	播放@song
播放满	播放@song
播放满身囔囔踹	播放@song
播放蔓延	播放@song
播放漫步	播放@song
播放漫步人生路	播放@song
播放漫动作	播放@song
播放漫漫人生路	播放@song
播放慢慢	播放@song
播放慢慢纪念	播放@song
播放慢慢落单	播放@song
播放慢热	播放@song
播放猫咪宝贝	播放@song
播放帽子戏法	播放@song
播放么么么么哒	播放@song
播放没道理	播放@song
播放没关系	播放@song
播放没了你,我把哭当成了笑	播放@song
播放没离开过	播放@song
播放没理由	播放@song
播放没那么坚强	播放@song
播放没那么简单	播放@song
播放没那种命	播放@song
播放没啥伤不起	播放@song
播放没什么	播放@song
播放没收	播放@song
播放没有你, 我什么都不是	播放@song
播放没有你的夜	播放@song
播放没有你陪伴我真的好孤单	播放@song
播放没有你陪伴真的好孤单	播放@song
播放没有你以后	播放@song
播放没有情人的情人节	播放@song
播放没有人爱	播放@song
播放没有人比我更爱你	播放@song
播放没有人像你	播放@song
播放没有如果	播放@song
播放没有什么不同	播放@song
播放没有勇气	播放@song
播放没有这首歌	播放@song
播放玫瑰	播放@song
播放玫瑰花的葬礼	播放@song
播放玫瑰玫瑰我爱你	播放@song
播放玫瑰是我偷的	播放@song
播放玫瑰是我偷的 但我爱你是真的	播放@song
播放眉飞色舞	播放@song
播放梅花弄弄弄	播放@song
播放梅花三弄	播放@song
播放梅花三弄弄	播放@song
播放梅兰梅兰我爱你	播放@song
播放每次都想呼喊你的名字	播放@song
播放每次和你走在路上都会看见一只喵	播放@song
播放每个人都会	播放@song
播放每个人都看到了希望	播放@song
播放每个人心中都有一片草原	播放@song
播放每天爱你多一点	播放@song
播放每一次让人心碎的	播放@song
播放每一生都等你	播放@song
播放每一天都不同	播放@song
播放美	播放@song
播放美错	播放@song
播放美杜莎	播放@song
播放美好的时光	播放@song
播放美好的一天	播放@song
播放美好的意外	播放@song
播放美好的昨天	播放@song
播放美酒加咖啡	播放@song
播放美了美了	播放@song
播放美丽的神话	播放@song
播放美丽的遇见	播放@song
播放美丽世界的孤儿	播放@song
播放美丽新世界	播放@song
播放美丽中国走起来	播放@song
播放美美哒	播放@song
播放美梦成真	播放@song
播放美女城市	播放@song
播放美女蛇	播放@song
播放美女与野兽	播放@song
播放美人	播放@song
播放美若黎明	播放@song
播放门	播放@song
播放门打开	播放@song
播放萌萌哒	播放@song
播放萌萌哒天团	播放@song
播放萌萌滴乖乖滴	播放@song
播放蒙娜丽莎的眼泪	播放@song
播放朦胧夜里谁等候	播放@song
播放猛龙过江	播放@song
播放梦	播放@song
播放梦不死	播放@song
播放梦草原	播放@song
播放梦缠绵	播放@song
播放梦带我旅行	播放@song
播放梦的翅膀受了伤	播放@song
播放梦的怒放	播放@song
播放梦回家乡	播放@song
播放梦里的泪	播放@song
播放梦里梦外	播放@song
播放梦千年之恋	播放@song
播放梦驼铃	播放@song
播放梦想摩天楼	播放@song
播放梦醒时分	播放@song
播放梦一场	播放@song
播放梦已残	播放@song
播放梦中想着你	播放@song
播放梦中新娘	播放@song
播放梦醉荷塘	播放@song
播放迷宫	播放@song
播放迷失的季节	播放@song
播放米店	播放@song
播放棉花糖	播放@song
播放勉强幸福	播放@song
播放面包的故事	播放@song
播放面面心跳	播放@song
播放面子问题	播放@song
播放渺小	播放@song
播放名字	播放@song
播放明明白白我的心	播放@song
播放明明就	播放@song
播放明明喜欢我	播放@song
播放明天，你好	播放@song
播放明天不上班	播放@song
播放明天的明天	播放@song
播放明天过后	播放@song
播放明天会更好	播放@song
播放明天你好	播放@song
播放明天我要嫁给你	播放@song
播放明天以后	播放@song
播放明星	播放@song
播放明星访谈	播放@song
播放明月	播放@song
播放明月本无心	播放@song
播放明知故犯	播放@song
播放明知做戏	播放@song
播放命硬	播放@song
播放命中注定	播放@song
播放模特	播放@song
播放摩登女郎	播放@song
播放摩天轮	播放@song
播放摩天轮的思念	播放@song
播放魔都	播放@song
播放魔法城堡	播放@song
播放魔鬼中的天使	播放@song
播放末班车	播放@song
播放末日不孤单	播放@song
播放茉莉花	播放@song
播放茉莉花开	播放@song
播放陌生人	播放@song
播放莫尼山	播放@song
播放莫斯科没有眼泪	播放@song
播放默	播放@song
播放某个心跳	播放@song
播放某某	播放@song
播放某年某月某天	播放@song
播放某人	播放@song
播放某时某刻	播放@song
播放母亲楼	播放@song
播放牡丹江	播放@song
播放木偶人的倒数第一个梦	播放@song
播放牧马人	播放@song
播放慕容雪	播放@song
播放穆桂英指路	播放@song
播放拿不起放不下你	播放@song
播放拿得起放不下	播放@song
播放哪里是你的拥抱	播放@song
播放那	播放@song
播放那栋楼	播放@song
播放那个静默的阳光午后	播放@song
播放那个男人	播放@song
播放那个远方	播放@song
播放那就摇头吧	播放@song
播放那就这样吧	播放@song
播放那里是哪里	播放@song
播放那么动情	播放@song
播放那么好	播放@song
播放那么骄傲	播放@song
播放那么再见	播放@song
播放那年	播放@song
播放那年初夏	播放@song
播放那年夏天	播放@song
播放那年印象刘三姐	播放@song
播放那片海	播放@song
播放那片星空那片海	播放@song
播放那时的光	播放@song
播放那时候	播放@song
播放那时候的我	播放@song
播放那时雨	播放@song
播放那是我	播放@song
播放那些爱过的事	播放@song
播放那些花儿	播放@song
播放那些年	播放@song
播放那些年，我们一起追过的女孩	播放@song
播放那些年我们一起追过的女孩	播放@song
播放那些女孩教我的事	播放@song
播放那一段日子	播放@song
播放那一年	播放@song
播放那一年那一天	播放@song
播放那一世	播放@song
播放那一天	播放@song
播放呐呐呐	播放@song
播放纳西索斯	播放@song
播放奶爸天团洗脑歌	播放@song
播放男儿当自强	播放@song
播放男人	播放@song
播放男人KTV	播放@song
播放男人的好	播放@song
播放男人的泪	播放@song
播放男人的痛	播放@song
播放男人的心伤不起	播放@song
播放男人歌	播放@song
播放男人海洋	播放@song
播放男人好难	播放@song
播放男人喝吧不是醉	播放@song
播放男人花	播放@song
播放男人女人	播放@song
播放男人辛苦	播放@song
播放男神专属	播放@song
播放南	播放@song
播放南部小城	播放@song
播放南方姑娘	播放@song
播放南瓜饼子店	播放@song
播放南海姑娘	播放@song
播放南来北往	播放@song
播放南屏晚钟	播放@song
播放难道	播放@song
播放难道伤心是你给我的温柔	播放@song
播放难道是我上辈子欠了你	播放@song
播放难念的经	播放@song
播放难忘的一天	播放@song
播放难以启齿的柔弱	播放@song
播放闹翻天	播放@song
播放闹够了没有	播放@song
播放内疚	播放@song
播放能不能	播放@song
播放霓虹深处	播放@song
播放你	播放@song
播放你把爱情给了谁	播放@song
播放你把第一次给了谁	播放@song
播放你把我灌醉	播放@song
播放你抱着别的女人入睡	播放@song
播放你被写在我的歌里	播放@song
播放你别连笑都那么勉强	播放@song
播放你并不懂我	播放@song
播放你不懂我	播放@song
播放你不会遇见第二个我	播放@song
播放你不来我不老	播放@song
播放你不能爱我	播放@song
播放你不是真正的快乐	播放@song
播放你不像她	播放@song
播放你不知道的事	播放@song
播放你曾对我说	播放@song
播放你曾是少年	播放@song
播放你的爱	播放@song
播放你的背包	播放@song
播放你的承诺	播放@song
播放你的第一	播放@song
播放你的酒窝没有酒	播放@song
播放你的冷漠逼我犯错	播放@song
播放你的每一次呼吸	播放@song
播放你的名字	播放@song
播放你的配角	播放@song
播放你的柔情我永远不懂	播放@song
播放你的生日	播放@song
播放你的微笑	播放@song
播放你的香气	播放@song
播放你的眼角流着我的泪	播放@song
播放你的眼睛	播放@song
播放你的眼睛背叛你的心	播放@song
播放你的眼泪是我的伤心	播放@song
播放你的眼神	播放@song
播放你的样子	播放@song
播放你懂不懂爱	播放@song
播放你懂得	播放@song
播放你懂的	播放@song
播放你对我太重要	播放@song
播放你飞吧	播放@song
播放你飞到城市另一边	播放@song
播放你干嘛	播放@song
播放你给的幸福不是我想要的	播放@song
播放你给我听好	播放@song
播放你还爱我吗	播放@song
播放你还会在吗	播放@song
播放你还记得吗	播放@song
播放你还怕大雨吗	播放@song
播放你还欠我一个拥抱	播放@song
播放你还是要走	播放@song
播放你还要我怎样	播放@song
播放你好，旧时光	播放@song
播放你好，再见	播放@song
播放你好灰姑娘	播放@song
播放你好就好	播放@song
播放你好可爱	播放@song
播放你好陌生人	播放@song
播放你很Low	播放@song
播放你很爱他	播放@song
播放你将看到	播放@song
播放你今天快乐吗	播放@song
播放你究竟有几个好妹妹	播放@song
播放你就不要想起我	播放@song
播放你就是梦想	播放@song
播放你就是我最想要的丫头	播放@song
播放你看你看月亮的脸	播放@song
播放你可以不爱我	播放@song
播放你可以不用给我答案	播放@song
播放你快回来	播放@song
播放你老了	播放@song
播放你瞒我瞒	播放@song
播放你没法激怒我	播放@song
播放你没那么爱我	播放@song
播放你那么爱他	播放@song
播放你能听见吗	播放@song
播放你牛什么牛	播放@song
播放你让我懂	播放@song
播放你若不离，我就不弃	播放@song
播放你若盛开	播放@song
播放你是草原我是花	播放@song
播放你是对的人	播放@song
播放你是如此难以忘记	播放@song
播放你是我曾经最爱的女人	播放@song
播放你是我抽了一晚的烟	播放@song
播放你是我的花朵	播放@song
播放你是我的玫瑰花	播放@song
播放你是我的女朋友	播放@song
播放你是我的唯一	播放@song
播放你是我的小幸福	播放@song
播放你是我的眼	播放@song
播放你是我的月亮	播放@song
播放你是我今生的依靠	播放@song
播放你是我今生最爱的女孩	播放@song
播放你是我所有的回忆	播放@song
播放你是我心爱的姑娘	播放@song
播放你是我胸口永远的痛	播放@song
播放你是我最爱的女人	播放@song
播放你说	播放@song
播放你说别再笑了	播放@song
播放你说会陪着我	播放@song
播放你说你很爱他	播放@song
播放你太善良	播放@song
播放你偷空了我的心	播放@song
播放你微笑时好美	播放@song
播放你心里最后一个	播放@song
播放你眼中的我	播放@song
播放你要的爱	播放@song
播放你一定会成功	播放@song
播放你一定要幸福	播放@song
播放你永远不知道	播放@song
播放你在烦恼什么	播放@song
播放你在看孤独的风景	播放@song
播放你在终点等我	播放@song
播放你怎么看	播放@song
播放你怎么舍得伤害我	播放@song
播放你怎么舍得我难过	播放@song
播放你怎么说	播放@song
播放你照顾好他.我四海为家	播放@song
播放你真的走了	播放@song
播放你只是不够爱我	播放@song
播放你只是经过	播放@song
播放你知道我在等你吗	播放@song
播放你知道我在等你们分手吗	播放@song
播放你走了	播放@song
播放你最珍贵	播放@song
播放妳	播放@song
播放逆光	播放@song
播放逆流成河	播放@song
播放逆态度	播放@song
播放逆袭吧少年	播放@song
播放逆战	播放@song
播放匿名的好友	播放@song
播放腻味	播放@song
播放年度之歌	播放@song
播放年轮	播放@song
播放年轮说	播放@song
播放年年	播放@song
播放年轻时代	播放@song
播放年少如风	播放@song
播放年少有你	播放@song
播放黏人的心动	播放@song
播放念亲恩	播放@song
播放娘娘我错了	播放@song
播放宁负天下不负你	播放@song
播放宁夏	播放@song
播放宁愿做梦	播放@song
播放凝而忧	播放@song
播放纽约的司机驾着北京的梦	播放@song
播放纽约司机驾着北京的梦	播放@song
播放浓烟下	播放@song
播放弄错的车站	播放@song
播放怒放的生命	播放@song
播放暖宝	播放@song
播放暖暖	播放@song
播放暖人	播放@song
播放虐心	播放@song
播放挪威的森林	播放@song
播放诺	播放@song
播放诺言	播放@song
播放女唱大锯不嗨都不行	播放@song
播放女唱拉锯听完在说话	播放@song
播放女儿红	播放@song
播放女儿情	播放@song
播放女孩当自强	播放@song
播放女皇	播放@song
播放女人不要哭	播放@song
播放女人的选择	播放@song
播放女人花	播放@song
播放女人们的咖啡	播放@song
播放女人之苦	播放@song
播放欧买嘎丝	播放@song
播放欧若拉	播放@song
播放偶尔还是会想起你	播放@song
播放偶尔平凡	播放@song
播放偶然	播放@song
播放偶遇的朋友	播放@song
播放偶阵雨	播放@song
播放藕断丝连	播放@song
播放啪啪啪	播放@song
播放怕什么	播放@song
播放拍错拖	播放@song
播放徘徊	播放@song
播放咆哮	播放@song
播放泡沫	播放@song
播放陪你	播放@song
播放陪你到最后	播放@song
播放陪你度过漫长岁月	播放@song
播放陪你一起看草原	播放@song
播放陪我到以后	播放@song
播放陪我看日出	播放@song
播放陪着你走	播放@song
播放陪着我的时候想着她	播放@song
播放配角	播放@song
播放朋友	播放@song
播放朋友的酒	播放@song
播放朋友而已	播放@song
播放朋友还是没有爱情伟大	播放@song
播放朋友名义	播放@song
播放朋友十年	播放@song
播放披着羊皮的狼	播放@song
播放皮皮虾我们走	播放@song
播放皮外伤	播放@song
播放琵琶行	播放@song
播放痞子的笑	播放@song
播放偏爱	播放@song
播放偏宠	播放@song
播放偏偏喜欢你	播放@song
播放蹁跹	播放@song
播放片羽时光	播放@song
播放骗子	播放@song
播放漂亮的姑娘就要嫁人啦	播放@song
播放漂洋过海来看你	播放@song
播放缥缃醉	播放@song
播放飘	播放@song
播放飘雪	播放@song
播放品乡愁	播放@song
播放平淡日子里的刺	播放@song
播放平凡之路	播放@song
播放平行世界	播放@song
播放平行线	播放@song
播放凭着爱	播放@song
播放泼茶香	播放@song
播放破天荒	播放@song
播放破晓	播放@song
播放破影而出	播放@song
播放扑火	播放@song
播放菩萨蛮	播放@song
播放蒲公英	播放@song
播放蒲公英的约定	播放@song
播放七里香	播放@song
播放七秒钟的记忆	播放@song
播放七情六欲	播放@song
播放七夕	播放@song
播放七月七的花	播放@song
播放七月上	播放@song
播放期待爱	播放@song
播放其实都没有	播放@song
播放其实很简单	播放@song
播放其实你懂我	播放@song
播放其实我还好	播放@song
播放其实我真的很在乎	播放@song
播放奇怪，我不懂得爱	播放@song
播放奇怪的你	播放@song
播放奇迹世界	播放@song
播放奇洛李维斯回信	播放@song
播放奇妙能力歌	播放@song
播放骑单车的日子	播放@song
播放棋子	播放@song
播放启程	播放@song
播放起灵	播放@song
播放泣灵	播放@song
播放恰似你的温柔	播放@song
播放千百度	播放@song
播放千方百计	播放@song
播放千古	播放@song
播放千里之外	播放@song
播放千年	播放@song
播放千年之恋	播放@song
播放千年之约	播放@song
播放千千阕歌	播放@song
播放千千阙歌	播放@song
播放千秋	播放@song
播放千山雪寂	播放@song
播放千言万语	播放@song
播放阡陌红尘	播放@song
播放芊芊	播放@song
播放牵手	播放@song
播放牵丝戏	播放@song
播放前前前世	播放@song
播放前座后座	播放@song
播放钱女友	播放@song
播放浅色爱情	播放@song
播放欠我的梦	播放@song
播放倩女幽魂	播放@song
播放强核暴走电音	播放@song
播放强迫症	播放@song
播放强求	播放@song
播放墙上的向日葵	播放@song
播放悄悄告诉你	播放@song
播放巧克力棒	播放@song
播放切尔西旅馆有沒有8310	播放@song
播放且行且珍惜	播放@song
播放且听风吟	播放@song
播放亲爱的	播放@song
播放亲爱的，那不是爱情	播放@song
播放亲爱的，你的棉裤真的不在我家	播放@song
播放亲爱的别让我受伤	播放@song
播放亲爱的不能到最后	播放@song
播放亲爱的还幸福吗	播放@song
播放亲爱的那不是爱情	播放@song
播放亲爱的你可知	播放@song
播放亲爱的你可知我有多么思念你	播放@song
播放亲爱的你听见了吗	播放@song
播放亲爱的你在哪里	播放@song
播放亲爱的小孩	播放@song
播放亲密爱人	播放@song
播放亲亲我的宝贝	播放@song
播放琴师	播放@song
播放青藏高原	播放@song
播放青城山下白素贞	播放@song
播放青春	播放@song
播放青春常驻	播放@song
播放青春花	播放@song
播放青春快乐	播放@song
播放青春没有终点	播放@song
播放青春万岁	播放@song
播放青春无悔	播放@song
播放青春修炼手册	播放@song
播放青春再见	播放@song
播放青花	播放@song
播放青花瓷	播放@song
播放青苹果乐园	播放@song
播放青青河边草	播放@song
播放青石板的诉说	播放@song
播放青蛙也会变王子	播放@song
播放青衣	播放@song
播放青云志	播放@song
播放轻狂	播放@song
播放倾国倾城	播放@song
播放倾尽所有	播放@song
播放倾尽天下	播放@song
播放倾世	播放@song
播放清风徐来	播放@song
播放清歌流觞	播放@song
播放清明上河图	播放@song
播放清平调	播放@song
播放清早儿	播放@song
播放情非得已	播放@song
播放情歌	播放@song
播放情歌唱给自己听	播放@song
播放情歌继续唱	播放@song
播放情歌没有告诉你	播放@song
播放情歌王	播放@song
播放情歌悠扬	播放@song
播放情花	播放@song
播放情话	播放@song
播放情话连篇	播放@song
播放情难枕	播放@song
播放情奴	播放@song
播放情囚	播放@song
播放情人	播放@song
播放情人啊	播放@song
播放情人劫	播放@song
播放情人结	播放@song
播放情殇	播放@song
播放情书不包邮	播放@song
播放情丝牵我心	播放@song
播放情网	播放@song
播放情为何物	播放@song
播放情绪挑拨	播放@song
播放情一动心就痛	播放@song
播放情与义	播放@song
播放情沼	播放@song
播放晴	播放@song
播放晴朗	播放@song
播放晴天	播放@song
播放请安静的忘记我	播放@song
播放请不要对我说sorry	播放@song
播放请不要在别人的肩上哭泣	播放@song
播放请到长城来滑雪	播放@song
播放请跟我来	播放@song
播放请跟我联络	播放@song
播放请你轻一点折磨我	播放@song
播放庆幸有你爱我	播放@song
播放穷浪漫	播放@song
播放秋殇别恋	播放@song
播放秋天	播放@song
播放秋意浓	播放@song
播放湫兮如风	播放@song
播放囚鸟	播放@song
播放求求你给点力	播放@song
播放曲终人散	播放@song
播放去吧！	播放@song
播放去大理	播放@song
播放去年今日	播放@song
播放权力与荣耀	播放@song
播放全部都给你	播放@song
播放全城热爱	播放@song
播放全民社会摇	播放@song
播放全世界丢弃了我你也不离开我	播放@song
播放全世界都在说东北话	播放@song
播放全世界你最美丽	播放@song
播放全世界谁倾听你	播放@song
播放全世界宣布爱你	播放@song
播放全是爱	播放@song
播放缺口	播放@song
播放群居动物	播放@song
播放然后呢	播放@song
播放燃点	播放@song
播放燃点真爱	播放@song
播放燃烧	播放@song
播放燃烧吧青春	播放@song
播放燃烧翅膀	播放@song
播放让爱飞起来	播放@song
播放让爱重生	播放@song
播放让每个人都心碎	播放@song
播放让全世界知道我爱你	播放@song
播放让时光在微风中倒流	播放@song
播放让世界毁灭	播放@song
播放让它说去	播放@song
播放让她飞吧	播放@song
播放让我欢喜让我忧	播放@song
播放让我留在你身边	播放@song
播放让我们荡起双桨	播放@song
播放让我们走下去	播放@song
播放让我忘记你是谁	播放@song
播放让我一次爱个够	播放@song
播放让我做你的眼睛	播放@song
播放让一切简单	播放@song
播放让一切随风	播放@song
播放让自己亮起来	播放@song
播放热河	播放@song
播放热浪	播放@song
播放热恋过后	播放@song
播放热情	播放@song
播放热情的沙漠	播放@song
播放热雪	播放@song
播放热血燃烧	播放@song
播放人非草木	播放@song
播放人嫁	播放@song
播放人间	播放@song
播放人间精品起来嗨	播放@song
播放人间沙	播放@song
播放人间天堂	播放@song
播放人生何处不相逢	播放@song
播放人生是一次热血的流浪	播放@song
播放人鱼的眼泪	播放@song
播放人鱼之歌	播放@song
播放人在江湖漂	播放@song
播放人质	播放@song
播放人走茶凉	播放@song
播放忍不住想念	播放@song
播放忍不住原谅	播放@song
播放认定	播放@song
播放认了	播放@song
播放认输	播放@song
播放认真的孩子气	播放@song
播放认真的雪	播放@song
播放扔掉吉他去找她	播放@song
播放日不落	播放@song
播放容易受伤的女人	播放@song
播放如果	播放@song
播放如果，不是	播放@song
播放如果爱老了	播放@song
播放如果爱忘了	播放@song
播放如果爱下去	播放@song
播放如果不是你	播放@song
播放如果的事	播放@song
播放如果分开我也爱你	播放@song
播放如果还有一次如果	播放@song
播放如果没有你	播放@song
播放如果没有他你还爱我吗	播放@song
播放如果能够	播放@song
播放如果你爱他	播放@song
播放如果你是我的传说	播放@song
播放如果你喜欢我	播放@song
播放如果你也听说	播放@song
播放如果你有梦想	播放@song
播放如果天还没黑	播放@song
播放如果我答应你	播放@song
播放如果我可以把你忘记	播放@song
播放如果一切没有发生过	播放@song
播放如果有来生	播放@song
播放如果有一天我们分开	播放@song
播放如果缘只到遇见	播放@song
播放如果云知道	播放@song
播放如果再次奔向你	播放@song
播放如果这都不算爱	播放@song
播放如果这就是爱情	播放@song
播放如果这是命	播放@song
播放如果这是情	播放@song
播放如何掉眼泪	播放@song
播放如梦	播放@song
播放如是	播放@song
播放如同悲伤被下载了两次	播放@song
播放儒道至圣	播放@song
播放入戏太深	播放@song
播放若不是那次夜空	播放@song
播放若无其事	播放@song
播放弱水三千	播放@song
播放洒拓歌	播放@song
播放萨克斯电音	播放@song
播放萨瓦迪卡	播放@song
播放赛尔号	播放@song
播放三寸天堂	播放@song
播放三分钟放纵	播放@song
播放三个人的晚餐	播放@song
播放三国	播放@song
播放三国杀	播放@song
播放三轮车	播放@song
播放三妻四妾	播放@song
播放三人游	播放@song
播放三生	播放@song
播放三生三世十里桃花	播放@song
播放三生烟火	播放@song
播放三十三块	播放@song
播放三十岁的女人	播放@song
播放三世	播放@song
播放三世缘	播放@song
播放三天三夜	播放@song
播放三万英尺	播放@song
播放三言两语来说爱	播放@song
播放散了吧	播放@song
播放杀死那朵花	播放@song
播放杀她死	播放@song
播放沙漠飞雪	播放@song
播放沙漠寂寞	播放@song
播放沙扬娜拉	播放@song
播放鲨啦啦	播放@song
播放傻瓜	播放@song
播放傻女	播放@song
播放傻子才悲伤	播放@song
播放傻子疯子和白痴	播放@song
播放山茶花	播放@song
播放山顶黑狗兄	播放@song
播放山谷里的回声	播放@song
播放山花	播放@song
播放山里的孩子	播放@song
播放山丘	播放@song
播放山水之间	播放@song
播放山阴路的夏天	播放@song
播放珊瑚海	播放@song
播放闪亮的日子	播放@song
播放闪闪的爱	播放@song
播放闪耀	播放@song
播放善变	播放@song
播放善良	播放@song
播放善意的谎言	播放@song
播放伤了你的心的我的心	播放@song
播放伤了心的女人怎么了	播放@song
播放伤心1999	播放@song
播放伤心城市	播放@song
播放伤心的海	播放@song
播放伤心的泪	播放@song
播放伤心的理由	播放@song
播放伤心的人别听慢歌	播放@song
播放伤心的站台	播放@song
播放伤心你的堕落	播放@song
播放伤心太平洋	播放@song
播放伤心童话	播放@song
播放殇雪	播放@song
播放上帝是个DJ	播放@song
播放上海姑娘	播放@song
播放上下	播放@song
播放上邪	播放@song
播放上心	播放@song
播放上瘾	播放@song
播放尚好的青春	播放@song
播放稍息立正站好	播放@song
播放少年锦时	播放@song
播放少年去游荡	播放@song
播放少女的祈祷	播放@song
播放少女情怀总是湿	播放@song
播放少女心	播放@song
播放奢香夫人	播放@song
播放舍不得	播放@song
播放舍不得过	播放@song
播放舍不得你	播放@song
播放舍不得忘记	播放@song
播放舍不得忘记你	播放@song
播放舍得	播放@song
播放舍离断	播放@song
播放社会摇	播放@song
播放社会摇起来	播放@song
播放社会摇之潮牌电子	播放@song
播放社会摇之混搭神曲	播放@song
播放社会摇之梦不如醒	播放@song
播放社会摇之咆哮火花	播放@song
播放身不由己	播放@song
播放身骑白马	播放@song
播放绅士	播放@song
播放深爱着你	播放@song
播放深海	播放@song
播放深蓝色的情书	播放@song
播放深深深	播放@song
播放深深深深	播放@song
播放深水炸弹7妹版	播放@song
播放深夜地下铁	播放@song
播放深夜鱼塘	播放@song
播放神锯必须给劲哈	播放@song
播放神马都给力	播放@song
播放神仙也移民	播放@song
播放神舟99号	播放@song
播放生来彷徨	播放@song
播放生命树	播放@song
播放生命像块石头	播放@song
播放生日那天	播放@song
播放生如夏花	播放@song
播放生生世世爱	播放@song
播放生卒年不详	播放@song
播放声律启蒙	播放@song
播放声音	播放@song
播放省略一万句	播放@song
播放圣诞告白	播放@song
播放圣诞结	播放@song
播放圣诞快乐	播放@song
播放盛开的石头	播放@song
播放盛夏的果实	播放@song
播放盛夏光年	播放@song
播放剩下的盛夏	播放@song
播放失宠	播放@song
播放失魂	播放@song
播放失恋	播放@song
播放失恋笔记	播放@song
播放失恋事小	播放@song
播放失恋听情歌	播放@song
播放失恋无罪	播放@song
播放失恋阵线联盟	播放@song
播放失落沙洲	播放@song
播放失眠	播放@song
播放失去之后	播放@song
播放失忆的金鱼	播放@song
播放失语者	播放@song
播放诗人漫步	播放@song
播放狮子座	播放@song
播放十八季	播放@song
播放十二年	播放@song
播放十九岁	播放@song
播放十里香	播放@song
播放十年	播放@song
播放十年戎马心孤单	播放@song
播放十年之约	播放@song
播放十三电音	播放@song
播放十送红军	播放@song
播放十一年	播放@song
播放十指紧扣	播放@song
播放石头记	播放@song
播放时光	播放@song
播放时光不老，我们不散	播放@song
播放时光不老我们不散	播放@song
播放时光海湾	播放@song
播放时光小偷	播放@song
播放时光谣	播放@song
播放时光正好	播放@song
播放时光诛仙	播放@song
播放时间的错	播放@song
播放时间都去哪儿了	播放@song
播放时间都去哪了	播放@song
播放时间里的	播放@song
播放时间有泪	播放@song
播放时间煮雨	播放@song
播放时空交错	播放@song
播放拾墙	播放@song
播放世间男人	播放@song
播放世间始终你好	播放@song
播放世界上最美的花	播放@song
播放世界之大	播放@song
播放世界之巅	播放@song
播放世末歌者	播放@song
播放世事何曾是绝对	播放@song
播放似是故人来	播放@song
播放似水流年	播放@song
播放势在必行	播放@song
播放试探你的温柔	播放@song
播放是非题	播放@song
播放是否	播放@song
播放是否我真的一无所有	播放@song
播放是你	播放@song
播放是你变了	播放@song
播放是日救星	播放@song
播放是时候	播放@song
播放是我不够好	播放@song
播放是我不好	播放@song
播放是我太笨了	播放@song
播放是我一人放不下	播放@song
播放是现实太现实	播放@song
播放逝去的爱	播放@song
播放逝去的爱情和青春	播放@song
播放逝去的诺言	播放@song
播放逝去日子	播放@song
播放收获爱情	播放@song
播放手放开	播放@song
播放手花	播放@song
播放手贴手的约定	播放@song
播放手写的从前	播放@song
播放手心的蔷薇	播放@song
播放手心里的温柔	播放@song
播放手心手背	播放@song
播放守	播放@song
播放守候在凌晨两点的伤心秀吧	播放@song
播放守望心与心的约定	播放@song
播放守卫	播放@song
播放守着你到永久	播放@song
播放受过伤的人	播放@song
播放书画中国	播放@song
播放输了你赢了世界又如何	播放@song
播放属于	播放@song
播放蜀道难	播放@song
播放蜀绣	播放@song
播放树读	播放@song
播放数不尽的星空	播放@song
播放甩你几条银河系	播放@song
播放双面人	播放@song
播放双抛桥	播放@song
播放双人舞	播放@song
播放霜雪千年	播放@song
播放谁伴我闯荡	播放@song
播放谁比我有范儿	播放@song
播放谁的眼泪在飞	播放@song
播放谁都不要说分手	播放@song
播放谁会记得	播放@song
播放谁可改变	播放@song
播放谁没年轻过	播放@song
播放谁明浪子心	播放@song
播放水果店的老板娘	播放@song
播放水墨丹青	播放@song
播放水墨江南	播放@song
播放水手	播放@song
播放水手公园	播放@song
播放水中花	播放@song
播放睡在我上铺的兄弟	播放@song
播放顺流而下	播放@song
播放顺其自然	播放@song
播放瞬间	播放@song
播放说不出口	播放@song
播放说不清	播放@song
播放说好不放手	播放@song
播放说好不后悔	播放@song
播放说好了不见面	播放@song
播放说谎	播放@song
播放说了再见	播放@song
播放说你为什么爱我	播放@song
播放说散就散	播放@song
播放说走就走的旅行	播放@song
播放丝绸之路	播放@song
播放丝萝	播放@song
播放私奔	播放@song
播放思美人	播放@song
播放思慕	播放@song
播放思念	播放@song
播放思念的距离	播放@song
播放思念如水	播放@song
播放思念是一把刀	播放@song
播放思念无期	播放@song
播放斯卡拉新版爆火	播放@song
播放撕夜	播放@song
播放死不回头	播放@song
播放死了都要爱	播放@song
播放死去活来	播放@song
播放死心	播放@song
播放死心塌地去爱你	播放@song
播放死性不改	播放@song
播放死一样的痛过	播放@song
播放四海	播放@song
播放四人游	播放@song
播放四叶草	播放@song
播放送别	播放@song
播放送给你的歌	播放@song
播放送你一朵山茶花	播放@song
播放送你一首吉祥的歌	播放@song
播放送情郎	播放@song
播放苏联战歌	播放@song
播放苏三说	播放@song
播放苏州河	播放@song
播放夙念	播放@song
播放素颜	播放@song
播放算你狠	播放@song
播放算什么男人	播放@song
播放随它吧	播放@song
播放随心所遇	播放@song
播放岁月缝花	播放@song
播放岁月如歌	播放@song
播放岁月神偷	播放@song
播放碎片	播放@song
播放碎碎恋	播放@song
播放锁	播放@song
播放他不爱我	播放@song
播放他不懂	播放@song
播放他不惯被爱	播放@song
播放他的猫	播放@song
播放他和她	播放@song
播放他和她的爱情故事	播放@song
播放他一定很爱你	播放@song
播放她	播放@song
播放她比我丑	播放@song
播放她不爱我	播放@song
播放她的背影	播放@song
播放她的眼睛会下雨	播放@song
播放她对我说谎	播放@song
播放她说	播放@song
播放她说她没喝醉	播放@song
播放她他	播放@song
播放她在睡梦中	播放@song
播放她只喝酒不说话	播放@song
播放踏马出征	播放@song
播放踏马出征展风采	播放@song
播放台湾制造	播放@song
播放太懂事的女人没人心疼	播放@song
播放太过爱你	播放@song
播放太好了	播放@song
播放太傻	播放@song
播放太坦白	播放@song
播放太阳	播放@song
播放太阳和月亮	播放@song
播放贪图	播放@song
播放昙花	播放@song
播放忐•忑	播放@song
播放叹服	播放@song
播放叹情缘	播放@song
播放唐人	播放@song
播放唐韵	播放@song
播放棠梨煎雪	播放@song
播放饕餮	播放@song
播放桃花缘记	播放@song
播放淘汰	播放@song
播放讨好	播放@song
播放套马杆	播放@song
播放特别	播放@song
播放特别的人	播放@song
播放特别想念你	播放@song
播放疼爱	播放@song
播放提拉米苏	播放@song
播放替我幸福	播放@song
播放替我照顾她	播放@song
播放天变地变情不变	播放@song
播放天才白痴梦	播放@song
播放天池南	播放@song
播放天窗	播放@song
播放天地梅花开	播放@song
播放天高地厚	播放@song
播放天行九歌	播放@song
播放天黑	播放@song
播放天黑黑	播放@song
播放天后	播放@song
播放天花乱坠之坠乱花天	播放@song
播放天空之城	播放@song
播放天亮就飞吧	播放@song
播放天亮了	播放@song
播放天亮说分手	播放@song
播放天路	播放@song
播放天若有情	播放@song
播放天使の泪	播放@song
播放天使的翅膀	播放@song
播放天使都哭了	播放@song
播放天使与海豚	播放@song
播放天书世界	播放@song
播放天堂的爱情	播放@song
播放天梯	播放@song
播放天天看到你	播放@song
播放天天晴朗	播放@song
播放天天想你	播放@song
播放天王盖地虎	播放@song
播放天下	播放@song
播放天下无敌	播放@song
播放天下有情人	播放@song
播放天涯	播放@song
播放天耀中华	播放@song
播放天真	播放@song
播放甜蜜蜜	播放@song
播放挑衅	播放@song
播放铁窗	播放@song
播放铁男传	播放@song
播放听海	播放@song
播放听见下雨的声音	播放@song
播放听妈妈的话	播放@song
播放听你听我	播放@song
播放听说	播放@song
播放听说爱情回来过	播放@song
播放听说你有了新的爱人	播放@song
播放听闻你混的风生水起	播放@song
播放听我说	播放@song
播放听着情歌流眼泪	播放@song
播放停格	播放@song
播放停转的木马	播放@song
播放同步	播放@song
播放同行	播放@song
播放同林	播放@song
播放同手同脚	播放@song
播放同样的情话	播放@song
播放同桌的你	播放@song
播放童话	播放@song
播放童话镇	播放@song
播放童梦	播放@song
播放童年	播放@song
播放童真年代	播放@song
播放痛	播放@song
播放痛苦算什么	播放@song
播放痛快	播放@song
播放痛快人生	播放@song
播放偷生	播放@song
播放偷偷	播放@song
播放偷偷爱你	播放@song
播放透鲜滴星期天	播放@song
播放突然的自我	播放@song
播放突然好想你	播放@song
播放突然想爱你	播放@song
播放突然想起你	播放@song
播放途中	播放@song
播放团圆饭	播放@song
播放退出	播放@song
播放娃娃脸	播放@song
播放瓦解	播放@song
播放外面的妞	播放@song
播放外面的世界	播放@song
播放完美生活	播放@song
播放完美世界	播放@song
播放完全因你	播放@song
播放完整爱	播放@song
播放玩Hiphop	播放@song
播放玩偶	播放@song
播放玩笑	播放@song
播放顽皮可以别赛脸	播放@song
播放晚安曲	播放@song
播放晚秋	播放@song
播放皖	播放@song
播放万花瞳	播放@song
播放万水千山总是爱	播放@song
播放万物生长	播放@song
播放万物无邪	播放@song
播放万一奥特曼打不赢小怪兽	播放@song
播放万有引力	播放@song
播放亡徒轰炸大电	播放@song
播放王妃	播放@song
播放王见王	播放@song
播放王牌对王牌	播放@song
播放王者荣耀	播放@song
播放王者之声	播放@song
播放王子的新衣	播放@song
播放网红	播放@song
播放网络宫殿	播放@song
播放网络一线牵	播放@song
播放往日时光	播放@song
播放往事随风	播放@song
播放往事欲如何	播放@song
播放往事只能回味	播放@song
播放往未来飞的客机	播放@song
播放忘不了爱过的我	播放@song
播放忘不了的你	播放@song
播放忘不了他，就忘了我	播放@song
播放忘尘谷	播放@song
播放忘川	播放@song
播放忘记的理由	播放@song
播放忘记你太难	播放@song
播放忘记你我做不到	播放@song
播放忘记时间	播放@song
播放忘记他	播放@song
播放忘了吧算了吧	播放@song
播放忘了你忘了我	播放@song
播放忘了牵手	播放@song
播放忘了去记得	播放@song
播放忘了我	播放@song
播放忘了我也不错	播放@song
播放忘情森巴舞	播放@song
播放忘情水	播放@song
播放忘情忘爱忘记你	播放@song
播放忘我	播放@song
播放危情追踪	播放@song
播放危险世界	播放@song
播放威廉姆船长	播放@song
播放微白城市	播放@song
播放微光	播放@song
播放微微一笑很倾城	播放@song
播放微信时代	播放@song
播放为爱痴狂	播放@song
播放为爱而活	播放@song
播放为爱感动	播放@song
播放为爱启程	播放@song
播放为爱停留	播放@song
播放为何分手了才说爱我	播放@song
播放为江山	播放@song
播放为了活着	播放@song
播放为了你	播放@song
播放为了荣耀	播放@song
播放为了遇见你	播放@song
播放为龙	播放@song
播放为梦而狂	播放@song
播放为梦而生	播放@song
播放为你伤自己的心	播放@song
播放为你脱掉	播放@song
播放为你我受冷风吹	播放@song
播放为你写的歌	播放@song
播放为你写诗	播放@song
播放为什么	播放@song
播放唯爱	播放@song
播放唯美越鼓极品钢琴	播放@song
播放唯一	播放@song
播放唯一纪念	播放@song
播放唯有兄弟	播放@song
播放伟大的母亲	播放@song
播放未曾相问	播放@song
播放未成年	播放@song
播放未婚妻	播放@song
播放未完成的爱恋	播放@song
播放未完成的爱情	播放@song
播放味道	播放@song
播放谓我	播放@song
播放喂 对不起	播放@song
播放温柔	播放@song
播放温柔乡	播放@song
播放温柔心愿	播放@song
播放温柔一击	播放@song
播放纹身	播放@song
播放吻别	播放@song
播放吻得太逼真	播放@song
播放吻你吻得太逼真	播放@song
播放吻我吧	播放@song
播放问佛	播放@song
播放问天问地问自己	播放@song
播放蜗牛	播放@song
播放我	播放@song
播放我爱的人	播放@song
播放我爱孤独和自由	播放@song
播放我爱故我在	播放@song
播放我爱你却不能在一起	播放@song
播放我爱你胜过你爱我	播放@song
播放我爱你中国	播放@song
播放我爱平底锅	播放@song
播放我爱他	播放@song
播放我爱洗澡	播放@song
播放我本人	播放@song
播放我变了 我没变	播放@song
播放我并不是那么坚强	播放@song
播放我不爱你了	播放@song
播放我不对	播放@song
播放我不会一个人	播放@song
播放我不难过	播放@song
播放我不能说	播放@song
播放我不是你该爱的那个人	播放@song
播放我不想念	播放@song
播放我不想忘记你	播放@song
播放我不要被你记住	播放@song
播放我不要再比了	播放@song
播放我不再相信	播放@song
播放我不知道爱是什么	播放@song
播放我才没有那样呢	播放@song
播放我曾爱过的女孩	播放@song
播放我宠爱	播放@song
播放我从草原来	播放@song
播放我从来没去过纽约	播放@song
播放我存在	播放@song
播放我错了吗	播放@song
播放我到外地去看你	播放@song
播放我的烦恼	播放@song
播放我的哥们我的好兄弟	播放@song
播放我的歌你会懂吗	播放@song
播放我的歌声里	播放@song
播放我的好兄弟	播放@song
播放我的滑板鞋	播放@song
播放我的皇后	播放@song
播放我的回忆不是我的	播放@song
播放我的快乐就是想你	播放@song
播放我的老爸老妈	播放@song
播放我的猫	播放@song
播放我的蒙古马	播放@song
播放我的梦	播放@song
播放我的秘密	播放@song
播放我的女人	播放@song
播放我的身边再也没有你	播放@song
播放我的时代	播放@song
播放我的天坑	播放@song
播放我的天空	播放@song
播放我的未来不是梦	播放@song
播放我的心你应该明白	播放@song
播放我的心是暖暖的	播放@song
播放我的心太乱	播放@song
播放我的心一直懂得	播放@song
播放我的心在海对面	播放@song
播放我的新郎在草原	播放@song
播放我的选择	播放@song
播放我的眼泪不为你说谎	播放@song
播放我的眼泪为谁飞	播放@song
播放我等到花儿也谢了	播放@song
播放我懂了	播放@song
播放我给你的音符代表全世界	播放@song
播放我管你	播放@song
播放我还不习惯	播放@song
播放我还想她	播放@song
播放我好喜欢你	播放@song
播放我好想你	播放@song
播放我好想你，这一秒	播放@song
播放我好像在哪见过你	播放@song
播放我和草原有个约定	播放@song
播放我很好	播放@song
播放我很好，那么你呢？	播放@song
播放我很难训！	播放@song
播放我很胖	播放@song
播放我很想爱他	播放@song
播放我恨我痴心	播放@song
播放我怀念的	播放@song
播放我会好好的	播放@song
播放我会记得你	播放@song
播放我会伤了你的心	播放@song
播放我叫小沈阳	播放@song
播放我就不爱唱情歌	播放@song
播放我就是爱	播放@song
播放我绝对不能失去你	播放@song
播放我绝对不说我爱你	播放@song
播放我可以抱你吗	播放@song
播放我可以忘记你	播放@song
播放我赖你	播放@song
播放我没你想的那么坚强	播放@song
播放我没有办法不去爱你	播放@song
播放我没有疯	播放@song
播放我没有伤心	播放@song
播放我门	播放@song
播放我们爱过就好	播放@song
播放我们爱音乐	播放@song
播放我们不该这样的	播放@song
播放我们不是情侣	播放@song
播放我们不是只有现在吗	播放@song
播放我们到底还能相信什么	播放@song
播放我们的爱	播放@song
播放我们的爱情	播放@song
播放我们的岛	播放@song
播放我们的歌	播放@song
播放我们的歌谣	播放@song
播放我们的故事	播放@song
播放我们的纪念日	播放@song
播放我们的路	播放@song
播放我们的明天	播放@song
播放我们的热血传奇	播放@song
播放我们的时光	播放@song
播放我们的约定	播放@song
播放我们的主题曲	播放@song
播放我们都爱过	播放@song
播放我们都被忘了	播放@song
播放我们都不坏	播放@song
播放我们都会错	播放@song
播放我们都没有错	播放@song
播放我们都能幸福着	播放@song
播放我们都受伤	播放@song
播放我们都一样	播放@song
播放我们好像在哪见过	播放@song
播放我们结婚吧	播放@song
播放我们结束了	播放@song
播放我们没有在一起	播放@song
播放我们是糖甜到悲伤	播放@song
播放我们说好的	播放@song
播放我们屯里的人	播放@song
播放我们相爱吧	播放@song
播放我们要走遍所有最浪漫的地方	播放@song
播放我们只差一点点	播放@song
播放我们总是在寻找	播放@song
播放我梦见我梦见我	播放@song
播放我明白	播放@song
播放我陪你	播放@song
播放我期待	播放@song
播放我如此爱你	播放@song
播放我设计一万种方式遇见你	播放@song
播放我什么都可以不要	播放@song
播放我是不是你最疼爱的人	播放@song
播放我是传奇	播放@song
播放我是大主宰	播放@song
播放我是否也在你心中	播放@song
播放我是火星人	播放@song
播放我是你的谁	播放@song
播放我是女王	播放@song
播放我是神仙	播放@song
播放我是淘歌大神	播放@song
播放我是一棵秋天的树	播放@song
播放我是一只船	播放@song
播放我是一只小小鸟	播放@song
播放我是一只鱼	播放@song
播放我是虞姬，那么你呢	播放@song
播放我是真的爱你	播放@song
播放我是真的爱上你	播放@song
播放我是真的爱他	播放@song
播放我说今晚月光那么美，你说是的	播放@song
播放我所放任的那些悲伤	播放@song
播放我所需要的	播放@song
播放我讨厌你	播放@song
播放我徒手从你的生活经过	播放@song
播放我为你歌唱	播放@song
播放我为自己代言	播放@song
播放我喜欢	播放@song
播放我想爱	播放@song
播放我想大声告诉你	播放@song
播放我想带你去美丽的春天	播放@song
播放我想对你说baby	播放@song
播放我想更懂你	播放@song
播放我想和你唱	播放@song
播放我想和你走下去	播放@song
播放我想结婚时	播放@song
播放我想我不够好	播放@song
播放我想先离开	播放@song
播放我想找个小对象	播放@song
播放我想做你的新郎	播放@song
播放我想做你的新娘	播放@song
播放我需要你	播放@song
播放我选择喜欢你	播放@song
播放我要抱着你	播放@song
播放我要大声的说爱你	播放@song
播放我要的不是再见	播放@song
播放我要的飞翔	播放@song
播放我要的现在就要	播放@song
播放我要飞	播放@song
播放我要给你	播放@song
播放我要你	播放@song
播放我要我们在一起	播放@song
播放我要夏天	播放@song
播放我要找到你	播放@song
播放我也不知为何流下了眼泪	播放@song
播放我也曾经像你一样	播放@song
播放我也憧憬过	播放@song
播放我也很想他	播放@song
播放我也想要当网红	播放@song
播放我一点都不难过	播放@song
播放我一点也不难过	播放@song
播放我一定要得到你	播放@song
播放我依然爱你	播放@song
播放我已收起锋芒	播放@song
播放我以为	播放@song
播放我以为，可以	播放@song
播放我以为还差一首抒情歌	播放@song
播放我有孤独和烈酒	播放@song
播放我有一帘幽梦	播放@song
播放我愿你知道	播放@song
播放我愿意	播放@song
播放我再也不会想她了	播放@song
播放我在红尘中遇见你	播放@song
播放我在你眼里到底算什么	播放@song
播放我在前世约了你	播放@song
播放我在神经什么	播放@song
播放我在太原和谁一起假装悲伤	播放@song
播放我怎么说	播放@song
播放我这个你不爱的人	播放@song
播放我这样的男人	播放@song
播放我真的受伤了	播放@song
播放我真的无法放弃	播放@song
播放我只是怕失去你	播放@song
播放我只在乎你	播放@song
播放我知道	播放@song
播放我知道你	播放@song
播放我知道你不爱我	播放@song
播放我知道你很爱她	播放@song
播放我知道你很难过	播放@song
播放我知道你离我不远	播放@song
播放我知道我不够完美	播放@song
播放我终于明白	播放@song
播放我最爱你我的大宝贝	播放@song
播放我最亲爱的	播放@song
播放我最摇摆	播放@song
播放我做不到不想你	播放@song
播放乌克丽丽	播放@song
播放乌兰巴托的夜	播放@song
播放乌云然	播放@song
播放屋顶	播放@song
播放屋企	播放@song
播放无·果	播放@song
播放无常	播放@song
播放无刺的玫瑰	播放@song
播放无敌	播放@song
播放无敌的寂寞	播放@song
播放无底洞	播放@song
播放无地自容	播放@song
播放无法放弃	播放@song
播放无法取代	播放@song
播放无法长大	播放@song
播放无悔这一生	播放@song
播放无际	播放@song
播放无间道	播放@song
播放无尽空虚	播放@song
播放无可取代	播放@song
播放无赖	播放@song
播放无泪的遗憾	播放@song
播放无朋友	播放@song
播放无情	播放@song
播放无情的雨无情的你	播放@song
播放无权爱我	播放@song
播放无人岛	播放@song
播放无人完美	播放@song
播放无声胜有声	播放@song
播放无所谓	播放@song
播放无畏	播放@song
播放无限得瑟	播放@song
播放无言	播放@song
播放无言守候	播放@song
播放无颜女	播放@song
播放无药可救	播放@song
播放无用	播放@song
播放无与伦比的美丽	播放@song
播放无语	播放@song
播放无知无觉	播放@song
播放无字碑	播放@song
播放吴哥窟	播放@song
播放吴克群	播放@song
播放五环之歌	播放@song
播放午夜DJ	播放@song
播放午夜剧	播放@song
播放舞变	播放@song
播放舞娘	播放@song
播放勿忘你	播放@song
播放悟空	播放@song
播放雾里看花	播放@song
播放夕阳之歌	播放@song
播放西瓜太郎	播放@song
播放西海情歌	播放@song
播放西门少年	播放@song
播放西厢	播放@song
播放吸引我	播放@song
播放希望	播放@song
播放希望爱	播放@song
播放稀薄	播放@song
播放习惯	播放@song
播放习惯失恋	播放@song
播放喜欢孤独	播放@song
播放喜欢寂寞	播放@song
播放喜欢两个人	播放@song
播放喜欢你	播放@song
播放喜欢你怎么办	播放@song
播放喜剧之王	播放@song
播放喜气洋洋	播放@song
播放喜气洋洋2015	播放@song
播放喜帖街	播放@song
播放喜相逢	播放@song
播放细味	播放@song
播放下辈子别再做女人	播放@song
播放下辈子不做女人	播放@song
播放下辈子也要找到你	播放@song
播放下辈子做你的女人	播放@song
播放下次爱你	播放@song
播放下次如果离开你	播放@song
播放下个，路口，见	播放@song
播放下个雨季	播放@song
播放下个转弯是你吗	播放@song
播放下完这场雨	播放@song
播放下一个天亮	播放@song
播放下一秒	播放@song
播放下一页的我	播放@song
播放下一站天后	播放@song
播放下一站永远	播放@song
播放下雨	播放@song
播放下雨天	播放@song
播放下雨天我没有带着雨伞	播放@song
播放下注	播放@song
播放夏洛特烦恼	播放@song
播放夏日梦	播放@song
播放夏日倾情	播放@song
播放夏天的风	播放@song
播放夏天的味道	播放@song
播放夏夜星空海	播放@song
播放仙女山的月亮	播放@song
播放仙侠棋缘花千骨	播放@song
播放闲的	播放@song
播放弦子	播放@song
播放现代爱情故事	播放@song
播放现实派悲伤	播放@song
播放现在我很幸褔	播放@song
播放现在已夜深	播放@song
播放线	播放@song
播放献世	播放@song
播放相爱不能见	播放@song
播放相爱的地方	播放@song
播放相爱的泪水	播放@song
播放相爱分开都是罪	播放@song
播放相爱很难	播放@song
播放相爱恨早	播放@song
播放相反的我	播放@song
播放相见不如怀念	播放@song
播放相见恨晚	播放@song
播放相识不如相见	播放@song
播放相思的秋	播放@song
播放相思的夜	播放@song
播放相思的债	播放@song
播放相思赋予谁	播放@song
播放相思垢	播放@song
播放相思网	播放@song
播放相信爱情相信你	播放@song
播放相信吗	播放@song
播放相依为命	播放@song
播放香巴拉并不遥远	播放@song
播放香草吧噗	播放@song
播放香草泡泡的季节	播放@song
播放香格里拉	播放@song
播放香水百合	播放@song
播放香水有毒	播放@song
播放想把我唱给你听	播放@song
播放想唱就唱	播放@song
播放想定下来	播放@song
播放想对你说	播放@song
播放想你	播放@song
播放想你的夜	播放@song
播放想你啦	播放@song
播放想你是一个秘密	播放@song
播放想你想到眼泪流	播放@song
播放想你想疯了	播放@song
播放想你想你	播放@song
播放想你心会痛	播放@song
播放想你在这个夜里	播放@song
播放想起你	播放@song
播放想神马有神马	播放@song
播放想说心里的话给你听	播放@song
播放想送你的礼物	播放@song
播放想我了吗	播放@song
播放想要爱你了	播放@song
播放想着你	播放@song
播放想着她	播放@song
播放想自由	播放@song
播放向北向北	播放@song
播放向前冲	播放@song
播放向日葵的约定	播放@song
播放向往	播放@song
播放巷子里的童年	播放@song
播放像风一样自由	播放@song
播放像个孩子	播放@song
播放像梦一样自由	播放@song
播放像你这样的朋友	播放@song
播放像天堂的悬崖	播放@song
播放像我这样的少年	播放@song
播放逍遥	播放@song
播放消失的月光	播放@song
播放潇洒的走	播放@song
播放潇洒小姐	播放@song
播放潇洒走一回	播放@song
播放小白	播放@song
播放小城大事	播放@song
播放小丑	播放@song
播放小丑的烦恼	播放@song
播放小方	播放@song
播放小芳	播放@song
播放小孩	播放@song
播放小猴子	播放@song
播放小黄人越鼓	播放@song
播放小角色	播放@song
播放小精灵	播放@song
播放小酒窝	播放@song
播放小路乱撞	播放@song
播放小蛮腰	播放@song
播放小毛驴	播放@song
播放小棉袄	播放@song
播放小女孩	播放@song
播放小苹果	播放@song
播放小气包	播放@song
播放小情歌	播放@song
播放小荃拳之歌	播放@song
播放小拳拳捶你胸口	播放@song
播放小拳拳捶胸口	播放@song
播放小三	播放@song
播放小时候	播放@song
播放小水果	播放@song
播放小岁月太着急	播放@song
播放小跳蛙	播放@song
播放小兔子乖乖	播放@song
播放小顽童	播放@song
播放小薇你在何方	播放@song
播放小相思	播放@song
播放小小	播放@song
播放小小的太阳	播放@song
播放小小新娘花	播放@song
播放小星星	播放@song
播放小幸福	播放@song
播放小幸运	播放@song
播放小学生	播放@song
播放小眼睛	播放@song
播放小燕子	播放@song
播放小永远	播放@song
播放小宇宙	播放@song
播放小缘家	播放@song
播放小镇姑娘	播放@song
播放笑到流泪	播放@song
播放笑红尘	播放@song
播放笑忘书	播放@song
播放笑着流泪	播放@song
播放鞋跟	播放@song
播放鞋子特大号	播放@song
播放写给童年的我	播放@song
播放写给我第一个喜欢的女孩的歌	播放@song
播放谢谢你	播放@song
播放谢谢你的爱	播放@song
播放谢谢你的爱1999	播放@song
播放谢谢你一直爱着我	播放@song
播放邂逅	播放@song
播放心·洞	播放@song
播放心不由己	播放@song
播放心动	播放@song
播放心会跟爱一起走	播放@song
播放心火	播放@song
播放心静听炊烟	播放@song
播放心裂	播放@song
播放心墙	播放@song
播放心如刀割	播放@song
播放心如玄铁	播放@song
播放心事如雨	播放@song
播放心术	播放@song
播放心酸	播放@song
播放心太软	播放@song
播放心疼你的心疼	播放@song
播放心痛	播放@song
播放心痛的曾经	播放@song
播放心痛的感觉	播放@song
播放心要痛到什么时候	播放@song
播放心有不甘	播放@song
播放心有灵犀	播放@song
播放心雨	播放@song
播放心在跳	播放@song
播放心臓	播放@song
播放心之火	播放@song
播放心中喜欢就说爱	播放@song
播放心醉	播放@song
播放辛德瑞拉	播放@song
播放新不了情	播放@song
播放新的心跳	播放@song
播放新贵妃醉酒	播放@song
播放新欢	播放@song
播放新年快乐	播放@song
播放新娘阿花	播放@song
播放新娘不是我	播放@song
播放新娘不是我DJ	播放@song
播放新女人花	播放@song
播放新千年等一回	播放@song
播放新生	播放@song
播放新窩	播放@song
播放新长征路上的摇滚	播放@song
播放信仰	播放@song
播放信仰之名	播放@song
播放信者得爱	播放@song
播放星光	播放@song
播放星光依旧灿烂	播放@song
播放星空	播放@song
播放星空下的守护	播放@song
播放星星	播放@song
播放星星的约会	播放@song
播放星星点灯	播放@song
播放星星月亮	播放@song
播放星月情缘	播放@song
播放星月神话	播放@song
播放幸福	播放@song
播放幸福的两个人	播放@song
播放幸福的两口子	播放@song
播放幸福的拥抱	播放@song
播放幸福伐木累	播放@song
播放幸福来了	播放@song
播放幸福了 然后呢	播放@song
播放幸福恋人	播放@song
播放幸福梦	播放@song
播放幸福是很容易的	播放@song
播放幸福未满的恋人	播放@song
播放幸福止痛	播放@song
播放幸运符号	播放@song
播放兄弟	播放@song
播放兄弟 想你了	播放@song
播放兄弟抱一下	播放@song
播放兄弟的酒	播放@song
播放兄弟干杯	播放@song
播放兄弟想你了	播放@song
播放兄弟一条命	播放@song
播放兄弟永远不变	播放@song
播放休止符	播放@song
播放修炼爱情	播放@song
播放羞答答的玫瑰静悄悄地开	播放@song
播放宿命	播放@song
播放袖手旁观	播放@song
播放虚度年华	播放@song
播放虚龄时代	播放@song
播放需要恋爱的夏天	播放@song
播放需要人陪	播放@song
播放许多年以后	播放@song
播放续集	播放@song
播放旋转音乐盒	播放@song
播放选你所爱	播放@song
播放薛之谦	播放@song
播放学会	播放@song
播放雪	播放@song
播放雪人	播放@song
播放雪夜	播放@song
播放勋章	播放@song
播放寻龙记	播放@song
播放寻梅	播放@song
播放寻你	播放@song
播放寻水的鱼	播放@song
播放寻找	播放@song
播放寻找和你的未来	播放@song
播放丫头	播放@song
播放鸭梨大	播放@song
播放亚特兰提斯	播放@song
播放胭脂	播放@song
播放胭脂泪	播放@song
播放烟	播放@song
播放烟蒂	播放@song
播放烟花易冷	播放@song
播放烟火	播放@song
播放烟火的光芒	播放@song
播放烟火里的尘埃	播放@song
播放烟笼长安	播放@song
播放沿海地带	播放@song
播放沿海公路的出口	播放@song
播放沿着月光	播放@song
播放眼鼻嘴	播放@song
播放眼睛想旅行	播放@song
播放眼泪	播放@song
播放眼泪的秘密	播放@song
播放眼泪的名字	播放@song
播放眼泪都在笑	播放@song
播放眼泪机场	播放@song
播放眼泪为你流	播放@song
播放眼泪知道	播放@song
播放眼里眉间	播放@song
播放眼前	播放@song
播放演技	播放@song
播放演员	播放@song
播放艳羡	播放@song
播放验伤	播放@song
播放燕归巢	播放@song
播放燕子	播放@song
播放扬鞭策马踏轮回	播放@song
播放阳光不燥.微风正好	播放@song
播放阳光不燥微风正好	播放@song
播放阳光下的我们	播放@song
播放阳光下的星星	播放@song
播放阳光照进回忆里	播放@song
播放阳光总在风雨后	播放@song
播放洋葱	播放@song
播放仰望	播放@song
播放氧气	播放@song
播放痒	播放@song
播放样	播放@song
播放侥幸者	播放@song
播放摇摆哥	播放@song
播放摇滚战士黄家驹	播放@song
播放摇篮曲	播放@song
播放摇摇宇宙	播放@song
播放遥远的距离	播放@song
播放瑶琴	播放@song
播放咬耳朵	播放@song
播放要命的迷人	播放@song
播放要说出来	播放@song
播放要死就一定要死在你手里	播放@song
播放要我怎么忘了他	播放@song
播放耶利亚女郎	播放@song
播放耶耶耶	播放@song
播放也许明天	播放@song
播放野百合也有春天	播放@song
播放野孩子	播放@song
播放野蛮女友	播放@song
播放野蛮生长	播放@song
播放野蔷薇	播放@song
播放野子	播放@song
播放叶问霜天	播放@song
播放叶子	播放@song
播放夜	播放@song
播放夜车	播放@song
播放夜店轰炸让你嗨到爆	播放@song
播放夜店极品	播放@song
播放夜机	播放@song
播放夜空中最亮的星	播放@song
播放夜三里	播放@song
播放夜色	播放@song
播放夜未央	播放@song
播放夜夜夜夜	播放@song
播放一把破吉他1999	播放@song
播放一百次分开	播放@song
播放一百七十二笔	播放@song
播放一半	播放@song
播放一辈子的赌注	播放@song
播放一辈子的孤单	播放@song
播放一不小心	播放@song
播放一场游戏一场梦	播放@song
播放一次就好	播放@song
播放一刀了断	播放@song
播放一点一滴	播放@song
播放一定要爱你	播放@song
播放一定要幸福	播放@song
播放一段情歌一段伤	播放@song
播放一对寂寞的心	播放@song
播放一个爱上浪漫的人	播放@song
播放一个备胎而已	播放@song
播放一个人	播放@song
播放一个人唱情歌	播放@song
播放一个人的北京	播放@song
播放一个人的冬天	播放@song
播放一个人的情歌	播放@song
播放一个人的森林	播放@song
播放一个人的圣诞节	播放@song
播放一个人的天荒地老	播放@song
播放一个人还是想着一个人	播放@song
播放一个人失忆	播放@song
播放一个人想着一个人	播放@song
播放一个人也不错	播放@song
播放一个人也会好好的	播放@song
播放一个人也可以幸福	播放@song
播放一个人也能好好过	播放@song
播放一个人走	播放@song
播放一个像夏天一个像秋天	播放@song
播放一剪梅	播放@song
播放一剑轻安	播放@song
播放一刻暧昧	播放@song
播放一块红布	播放@song
播放一帘幽梦	播放@song
播放一路不变	播放@song
播放一路两个人	播放@song
播放一路上有你	播放@song
播放一璐到底	播放@song
播放一梦两三年	播放@song
播放一面湖水	播放@song
播放一秒的记忆	播放@song
播放一秒钟	播放@song
播放一年级	播放@song
播放一念天堂	播放@song
播放一念之间	播放@song
播放一念执着	播放@song
播放一拍两散	播放@song
播放一起吃苦的幸福	播放@song
播放一起飞	播放@song
播放一起老去	播放@song
播放一起喔喔	播放@song
播放一起摇摆	播放@song
播放一起走过的日子	播放@song
播放一千个伤心的理由	播放@song
播放一千万个理由	播放@song
播放一腔诗意喂了狗	播放@song
播放一切安好	播放@song
播放一曲神摇	播放@song
播放一曲相思	播放@song
播放一人两袖清风	播放@song
播放一人六神无主	播放@song
播放一人我两袖清风	播放@song
播放一人我六神无主	播放@song
播放一人我饮酒醉	播放@song
播放一人我战四方	播放@song
播放一人饮酒醉	播放@song
播放一人饮我酒醉	播放@song
播放一人战歌	播放@song
播放一日七失	播放@song
播放一山好锋光	播放@song
播放一生爱你千百回	播放@song
播放一生不变	播放@song
播放一生痴心	播放@song
播放一生等待这一天	播放@song
播放一生何求	播放@song
播放一生去守候	播放@song
播放一生守候	播放@song
播放一生所爱	播放@song
播放一生无悔	播放@song
播放一生兄弟	播放@song
播放一生一世好兄弟	播放@song
播放一生有你	播放@song
播放一生中最爱	播放@song
播放一生最爱的人	播放@song
播放一事无成	播放@song
播放一首简单的歌	播放@song
播放一首心歌	播放@song
播放一天到晚游泳的鱼	播放@song
播放一天一点爱恋	播放@song
播放一条小船瓢四方	播放@song
播放一万次悲伤	播放@song
播放一万个对不起	播放@song
播放一万个女人	播放@song
播放一万个舍不得	播放@song
播放一吻天荒	播放@song
播放一吻之间	播放@song
播放一无所有	播放@song
播放一物降一物	播放@song
播放一箱子云朵	播放@song
播放一想到你呀	播放@song
播放一笑而过	播放@song
播放一笑倾城	播放@song
播放一袖云	播放@song
播放一言难尽	播放@song
播放一样	播放@song
播放一样的月光	播放@song
播放一亿个伤心	播放@song
播放一于奉陪	播放@song
播放一整夜Allnight	播放@song
播放一只蝴蝶	播放@song
播放一枝独秀	播放@song
播放一直都在	播放@song
播放一直想着他	播放@song
播放一直在等你	播放@song
播放一种感觉	播放@song
播放一字一泪	播放@song
播放伊人如梦	播放@song
播放依恋	播放@song
播放依然爱你	播放@song
播放依然是你	播放@song
播放依然在一起	播放@song
播放遗憾	播放@song
播放遗失的美好	播放@song
播放遗失的心跳	播放@song
播放遗忘	播放@song
播放遗忘之前	播放@song
播放疑心病	播放@song
播放以后别做朋友	播放@song
播放以后的以后	播放@song
播放以剑之名—血薇	播放@song
播放异地恋	播放@song
播放异类	播放@song
播放异乡人	播放@song
播放异想记	播放@song
播放驿动的心	播放@song
播放弈剑听雨阁	播放@song
播放逸后	播放@song
播放意外	播放@song
播放臆想	播放@song
播放因改变而美丽	播放@song
播放因为爱所以爱	播放@song
播放因为爱着你	播放@song
播放因为你	播放@song
播放因为有你	播放@song
播放因为遇见你	播放@song
播放阴天	播放@song
播放阴天快乐	播放@song
播放音频怪物	播放@song
播放饮马江湖风萧萧	播放@song
播放隐身守候	播放@song
播放隐形的翅膀	播放@song
播放隐形纪念	播放@song
播放瘾	播放@song
播放英雄故事	播放@song
播放英雄联盟超神曲	播放@song
播放英雄联盟之大圣归来	播放@song
播放英雄寞	播放@song
播放樱吹雪	播放@song
播放萤火	播放@song
播放影子情人	播放@song
播放拥抱	播放@song
播放拥抱爱	播放@song
播放拥抱你	播放@song
播放拥挤的梦想	播放@song
播放庸人自扰	播放@song
播放永不放弃	播放@song
播放永巷人	播放@song
播放永远	播放@song
播放永远爱着你	播放@song
播放永远不分开	播放@song
播放永远不回头	播放@song
播放永远不忘你本兮	播放@song
播放永远的兄弟	播放@song
播放永远永远	播放@song
播放勇	播放@song
播放勇敢	播放@song
播放勇敢爱	播放@song
播放勇敢爱情	播放@song
播放勇敢的我	播放@song
播放勇敢的心	播放@song
播放勇敢勇敢	播放@song
播放勇敢绽放	播放@song
播放勇气	播放@song
播放蛹	播放@song
播放用心良苦	播放@song
播放用余生去爱	播放@song
播放游爱民族	播放@song
播放游戏人间	播放@song
播放友情岁月	播放@song
播放友谊的小船	播放@song
播放友谊的小船说翻就翻	播放@song
播放有爱会结缘	播放@song
播放有爱难言	播放@song
播放有点儿意思	播放@song
播放有点舍不得	播放@song
播放有点甜	播放@song
播放有多少爱可以重来	播放@song
播放有个爱你的人不容易	播放@song
播放有个傻瓜爱过你	播放@song
播放有故事的人	播放@song
播放有光的地方	播放@song
播放有何不可	播放@song
播放有借有还	播放@song
播放有可能的夜晚	播放@song
播放有了爱情就别碰暧昧	播放@song
播放有理取闹	播放@song
播放有没有	播放@song
播放有没有那么一首歌	播放@song
播放有没有人告诉你	播放@song
播放有没有一首歌会让你想起我	播放@song
播放有梦有朋友	播放@song
播放有你	播放@song
播放有你，就好	播放@song
播放有你的快乐	播放@song
播放有你的远方	播放@song
播放有你就不怕冒险	播放@song
播放有钱你买不到	播放@song
播放有情人终成兄妹	播放@song
播放有情世间	播放@song
播放有生一天	播放@song
播放有时寂寞	播放@song
播放有我在	播放@song
播放有些人走着走着就散了DJ	播放@song
播放有心人	播放@song
播放有形的翅膀	播放@song
播放有一点动心	播放@song
播放有一个地方	播放@song
播放有种你爱我	播放@song
播放又爱又恨	播放@song
播放又见山里红	播放@song
播放幼稚完	播放@song
播放余罪	播放@song
播放鱼	播放@song
播放鱼鸟之恋	播放@song
播放鱼水情歌	播放@song
播放鱼跃龙门	播放@song
播放渔圈	播放@song
播放愚爱	播放@song
播放与爱情无关	播放@song
播放与你好不好无关	播放@song
播放与我无关	播放@song
播放雨，不要停	播放@song
播放雨爱	播放@song
播放雨蝶	播放@song
播放雨好	播放@song
播放雨花石	播放@song
播放雨季	播放@song
播放雨天	播放@song
播放雨夜	播放@song
播放雨一直下	播放@song
播放雨樱花	播放@song
播放雨中的姑娘	播放@song
播放雨中慢摇	播放@song
播放雨中飘荡的回忆	播放@song
播放预谋	播放@song
播放欲言又止	播放@song
播放遇见	播放@song
播放御姐控	播放@song
播放御龙归字谣	播放@song
播放御龙铭千古	播放@song
播放御龙品青梅	播放@song
播放原动力	播放@song
播放原来	播放@song
播放原来爱情没有刚刚好	播放@song
播放原来爱情这么伤	播放@song
播放原来的我	播放@song
播放原来都是梦	播放@song
播放原来你并不爱我	播放@song
播放原来你从来没有爱过我	播放@song
播放原来你也在这里	播放@song
播放原来我是第三者	播放@song
播放原谅	播放@song
播放原谅他	播放@song
播放原谅我就是这样的女生	播放@song
播放原谅我要高飞	播放@song
播放原香草	播放@song
播放缘	播放@song
播放缘分的天空	播放@song
播放缘分惹的祸	播放@song
播放缘分一道桥	播放@song
播放缘份	播放@song
播放缘尽了爱散了	播放@song
播放远方	播放@song
播放远在北方孤独的鬼	播放@song
播放远在眼前的你	播放@song
播放愿得一人心	播放@song
播放愿时间告诉你	播放@song
播放愿作鸳鸯不羡仙	播放@song
播放约定	播放@song
播放约会王图艾	播放@song
播放約束 -Promise code-	播放@song
播放約束-Promise code-	播放@song
播放月半小夜曲	播放@song
播放月到天心处	播放@song
播放月儿弯弯	播放@song
播放月光	播放@song
播放月亮粑粑	播放@song
播放月亮代表我的心	播放@song
播放月亮可以代表我的心	播放@song
播放月亮惹的祸	播放@song
播放月满弦	播放@song
播放月牙湾	播放@song
播放月圆花好	播放@song
播放越爱越精彩	播放@song
播放越爱越难过	播放@song
播放越来越不懂	播放@song
播放越难越爱	播放@song
播放越伤越爱	播放@song
播放越夜越有机	播放@song
播放越长大越孤单	播放@song
播放越走越远的旅客	播放@song
播放再爱一遍	播放@song
播放再不疯狂我们就老了	播放@song
播放再唱一首	播放@song
播放再次爱上你	播放@song
播放再次相信	播放@song
播放再度重相逢	播放@song
播放再飞行	播放@song
播放再回首	播放@song
播放再见	播放@song
播放再见 你好	播放@song
播放再见 再见	播放@song
播放再见!我的爱人	播放@song
播放再见爱情	播放@song
播放再见北极雪	播放@song
播放再见的理由	播放@song
播放再见二丁目	播放@song
播放再见了我的爱	播放@song
播放再见理想	播放@song
播放再见陌生人	播放@song
播放再见小时候	播放@song
播放再见亦是泪	播放@song
播放再见又是晴天	播放@song
播放再见再见	播放@song
播放再见只是陌生人	播放@song
播放再见自己	播放@song
播放再聚首	播放@song
播放再陪我看一次	播放@song
播放再痛也没关系	播放@song
播放再也不去丽江	播放@song
播放再遇见	播放@song
播放在，也不见	播放@song
播放在此刻	播放@song
播放在冬天和奶奶一起晒太阳	播放@song
播放在火光中唱歌	播放@song
播放在劫难逃	播放@song
播放在木星	播放@song
播放在你的身边	播放@song
播放在你离开那一天	播放@song
播放在你身边	播放@song
播放在你之后	播放@song
播放在水一方	播放@song
播放在他乡	播放@song
播放在我想起来	播放@song
播放在希望的田野上	播放@song
播放在心里从此永远有个你	播放@song
播放在幸福的路上	播放@song
播放在一块	播放@song
播放在一起	播放@song
播放在雨中	播放@song
播放在雨中不能说雨	播放@song
播放在雨中漫步一整夜	播放@song
播放在最美年纪遇见你	播放@song
播放咱们结婚吧	播放@song
播放葬花吟	播放@song
播放早春的树	播放@song
播放贼	播放@song
播放怎么办我爱你	播放@song
播放怎么会狠心伤害我	播放@song
播放怎么会这样	播放@song
播放怎么能忘了	播放@song
播放怎么忍心	播放@song
播放怎么说我不爱你	播放@song
播放怎么天生不是女人	播放@song
播放怎能放开你的手	播放@song
播放怎样	播放@song
播放怎样说清此刻的心情	播放@song
播放斩仙	播放@song
播放战放	播放@song
播放战无不胜	播放@song
播放战争世界	播放@song
播放战中神话	播放@song
播放站起来	播放@song
播放站台2010	播放@song
播放站在草原望北京	播放@song
播放张三的歌	播放@song
播放张三的另一首歌	播放@song
播放长安忆	播放@song
播放长城	播放@song
播放长大的童话	播放@song
播放长大以后的世界	播放@song
播放长情的告白	播放@song
播放长生诀	播放@song
播放长相依	播放@song
播放掌心里的海	播放@song
播放招呼你朋友	播放@song
播放找到天使了	播放@song
播放找对的人	播放@song
播放找自己	播放@song
播放哲家封神榜第二部	播放@song
播放这，就是爱	播放@song
播放这歌不错	播放@song
播放这个年纪	播放@song
播放这个曲子慢慢感受	播放@song
播放这个世界会好吗	播放@song
播放这个夏天	播放@song
播放这节奏绝对有牌面	播放@song
播放这就是命	播放@song
播放这么多年了	播放@song
播放这么近	播放@song
播放这首歌是我写给你的	播放@song
播放这条街	播放@song
播放这一路走来	播放@song
播放这一种痛	播放@song
播放着迷	播放@song
播放着魔	播放@song
播放珍惜	播放@song
播放珍珠	播放@song
播放真爱放手	播放@song
播放真爱末年	播放@song
播放真爱你的云	播放@song
播放真的，用了心	播放@song
播放真的爱你	播放@song
播放真的不容易	播放@song
播放真的好想你	播放@song
播放真的很在乎	播放@song
播放真的停不下来	播放@song
播放真心换伤心	播放@song
播放真英雄	播放@song
播放震得你鼻血泛滥	播放@song
播放争气	播放@song
播放征服	播放@song
播放拯救	播放@song
播放整座城市的安慰	播放@song
播放正好	播放@song
播放正义之道	播放@song
播放之子于归	播放@song
播放只不过是	播放@song
播放只对你说	播放@song
播放只对你有感觉	播放@song
播放只能陪你到这里	播放@song
播放只欠秋天	播放@song
播放只是没有如果	播放@song
播放只是女人	播放@song
播放只是朋友	播放@song
播放只是睡过吧	播放@song
播放只是太爱你	播放@song
播放只想一生跟你走	播放@song
播放只要有你	播放@song
播放只有为你	播放@song
播放只愿你好	播放@song
播放只愿与你	播放@song
播放知己	播放@song
播放知己.自己	播放@song
播放知己自己	播放@song
播放知心当玩偶	播放@song
播放知心朋友	播放@song
播放知足	播放@song
播放栀子花开	播放@song
播放执迷不悔	播放@song
播放执着	播放@song
播放执子之手	播放@song
播放直到那一天	播放@song
播放直到遇见你	播放@song
播放直觉	播放@song
播放值得	播放@song
播放值得就好	播放@song
播放纸包不住火	播放@song
播放纸飞机	播放@song
播放指纹	播放@song
播放至少还有你	播放@song
播放制造浪漫	播放@song
播放致爱	播放@song
播放致命的甜蜜	播放@song
播放致未来的你	播放@song
播放致自己	播放@song
播放窒息	播放@song
播放中国V5	播放@song
播放中国范儿	播放@song
播放中国功夫	播放@song
播放中国吉祥	播放@song
播放中国美	播放@song
播放中国喜事	播放@song
播放终点起点	播放@song
播放终身美丽	播放@song
播放终于	播放@song
播放终于等到你	播放@song
播放终于我们	播放@song
播放钟无艳	播放@song
播放重度寂寞	播放@song
播放重复的伤	播放@song
播放重来	播放@song
播放朱丽叶的秋天	播放@song
播放诛仙恋	播放@song
播放竹林抚琴	播放@song
播放逐鹿	播放@song
播放逐梦令	播放@song
播放主要是看气质	播放@song
播放祝福你亲爱的	播放@song
播放祝福你兄弟	播放@song
播放祝君好	播放@song
播放祝你生日快乐	播放@song
播放祝你幸福	播放@song
播放祝你一路顺风	播放@song
播放祝我生日快乐	播放@song
播放专属7粉的浪锯	播放@song
播放专属味道	播放@song
播放转机	播放@song
播放转身离开	播放@song
播放转弯	播放@song
播放装逼专用神曲	播放@song
播放装蒜	播放@song
播放壮志在我胸	播放@song
播放追风少年	播放@song
播放追风筝的孩子	播放@song
播放追梦赤子心	播放@song
播放追梦人	播放@song
播放捉泥鳅	播放@song
播放卓玛	播放@song
播放子时	播放@song
播放自己	播放@song
播放自己的舞台	播放@song
播放自己的心情自己感受	播放@song
播放自拍	播放@song
播放自然醒	播放@song
播放自饰者	播放@song
播放自首	播放@song
播放自由自在	播放@song
播放自作多情	播放@song
播放走不近的爱	播放@song
播放走狗	播放@song
播放走马	播放@song
播放走天涯	播放@song
播放走在红毯那一天	播放@song
播放走在冷风中	播放@song
播放走着走着就散了	播放@song
播放钻石	播放@song
播放钻石糖	播放@song
播放最爱	播放@song
播放最爱的你	播放@song
播放最爱的人	播放@song
播放最爱的人伤我最深	播放@song
播放最爱是谁	播放@song
播放最爱最恨都是你	播放@song
播放最卑微的愿望	播放@song
播放最差不过是孤独	播放@song
播放最初的梦想	播放@song
播放最初的信仰	播放@song
播放最对的人	播放@song
播放最孤独的人	播放@song
播放最好的安排	播放@song
播放最好的朋友	播放@song
播放最好的时光	播放@song
播放最好的时刻	播放@song
播放最好的未来	播放@song
播放最好的我们	播放@song
播放最好的幸福	播放@song
播放最好的夜晚	播放@song
播放最后的安慰	播放@song
播放最后的一句挽留	播放@song
播放最后的约定	播放@song
播放最后是我开了口	播放@song
播放最后我们都变了	播放@song
播放最后一次看不见那些人老去	播放@song
播放最后一次看着你	播放@song
播放最后一个夏天	播放@song
播放最后一面	播放@song
播放最近比较烦	播放@song
播放最酷的天才	播放@song
播放最浪漫的事	播放@song
播放最美	播放@song
播放最美的草原遇见你	播放@song
播放最美的等候	播放@song
播放最美的花季	播放@song
播放最美的婚纱	播放@song
播放最美的时光	播放@song
播放最美的中国	播放@song
播放最美中国风	播放@song
播放最亲爱的你	播放@song
播放最熟悉的陌生人	播放@song
播放最天使	播放@song
播放最痛的人	播放@song
播放最心疼的女人	播放@song
播放最炫民族风	播放@song
播放最炫小苹果	播放@song
播放最远的距离	播放@song
播放最长的电影	播放@song
播放最长的旅途	播放@song
播放最真的心	播放@song
播放最重要的决定	播放@song
播放罪过	播放@song
播放醉	播放@song
播放醉城伤	播放@song
播放醉清风	播放@song
播放醉西楼	播放@song
播放醉相思	播放@song
播放醉逍遥	播放@song
播放尊严	播放@song
播放불꽃	播放@song
播放昨天的你的现在的未来	播放@song
播放昨天今天	播放@song
播放昨夜星辰	播放@song
播放左半边翅膀	播放@song
播放左边	播放@song
播放左肩	播放@song
播放左手边	播放@song
播放左右手	播放@song
播放左右为难	播放@song
播放作曲家	播放@song
播放作者	播放@song
播放座右铭	播放@song
播放做你的微光	播放@song
播放做你的新娘	播放@song
播放做你的幸福宝贝	播放@song
播放做你的兄弟	播放@song
播放做你心上的人	播放@song
播放做人别太飘	播放@song
播放做我的小公主吧	播放@song
播放做我老婆好不好	播放@song
播放钢琴演奏的歌	播放@instrument演奏的歌
播放萨克斯演奏的歌	播放@instrument演奏的歌
播放萨克斯风的歌	播放@instrument演奏的歌
播放萨克斯管演奏的歌	播放@instrument演奏的歌
播放吉他演奏的歌	播放@instrument演奏的歌
播放吉它演奏的歌	播放@instrument演奏的歌
播放六弦琴演奏的歌	播放@instrument演奏的歌
播放小提琴演奏的歌	播放@instrument演奏的歌
播放流行歌曲	播放@style歌曲
播放摇滚歌曲	播放@style歌曲
播放劲爆的歌曲	播放@style歌曲
播放嗨歌	播放@style歌曲
播放世界音乐歌曲	播放@style歌曲
播放爵士歌曲	播放@style歌曲
播放古典歌曲	播放@style歌曲
播放拉丁歌曲	播放@style歌曲
播放南美歌曲	播放@style歌曲
播放南美洲歌曲	播放@style歌曲
播放拉丁美洲歌曲	播放@style歌曲
播放电子歌曲	播放@style歌曲
播放电子音乐	播放@style歌曲
播放电音歌曲	播放@style歌曲
播放电子乐歌曲	播放@style歌曲
播放有声书歌曲	播放@style歌曲
播放嘻哈说唱歌曲	播放@style歌曲
播放hip-hop歌曲	播放@style歌曲
播放hiphop歌曲	播放@style歌曲
播放说唱歌曲	播放@style歌曲
播放rap歌曲	播放@style歌曲
播放饶舌歌曲	播放@style歌曲
播放民谣歌曲	播放@style歌曲
播放原声歌曲	播放@style歌曲
播放乡村歌曲	播放@style歌曲
播放新世纪歌曲	播放@style歌曲
播放金属歌曲	播放@style歌曲
播放朋克歌曲	播放@style歌曲
播放节奏布鲁斯歌曲	播放@style歌曲
播放基督音乐歌曲	播放@style歌曲
播放蓝调歌曲	播放@style歌曲
播放舞曲歌曲	播放@style歌曲
播放雷鬼歌曲	播放@style歌曲
播放轻音乐歌曲	播放@style歌曲
播放韩国流行歌曲	播放@style歌曲
播放节日音乐	播放@style歌曲
播放儿童音乐	播放@style歌曲
播放另类摇滚歌曲	播放@style歌曲
播放另类流行歌曲	播放@style歌曲
播放另类歌曲	播放@style歌曲
播放福音歌曲	播放@style歌曲
播放嘻哈歌曲	播放@style歌曲
播放浩室歌曲	播放@style歌曲
播放歌剧歌曲	播放@style歌曲
播放R&B歌曲	播放@style歌曲
播放RnB歌曲	播放@style歌曲
播放节奏蓝调歌曲	播放@style歌曲
播放节奏怨曲	播放@style歌曲
播放混杂歌曲	播放@style歌曲
播放独立音乐歌曲	播放@style歌曲
播放日本流行歌曲	播放@style歌曲
播放人声歌曲	播放@style歌曲
播放当代成人歌曲	播放@style歌曲
播放音乐剧歌曲	播放@style歌曲
播放中国传统歌曲	播放@style歌曲
播放唱作人歌曲	播放@style歌曲
播放巴西音乐歌曲	播放@style歌曲
播放中国民乐歌曲	播放@style歌曲
播放古典跨界歌曲	播放@style歌曲
播放后摇歌曲	播放@style歌曲
播放戏曲歌曲	播放@style歌曲
播放放克乐歌曲	播放@style歌曲
播放中国民歌歌曲	播放@style歌曲
播放香颂歌曲	播放@style歌曲
播放灵魂乐歌曲	播放@style歌曲
播放伴奏歌曲	播放@style歌曲
播放英伦歌曲	播放@style歌曲
播放动漫歌曲	播放@style歌曲
播放驰放歌曲	播放@style歌曲
播放疗伤的歌	播放@emotion的歌
播放治愈的歌	播放@emotion的歌
播放伤感的歌	播放@emotion的歌
播放悲伤的歌	播放@emotion的歌
播放伤悲的歌	播放@emotion的歌
播放忧伤的歌	播放@emotion的歌
播放快乐的歌	播放@emotion的歌
播放高兴的歌	播放@emotion的歌
播放开心的歌	播放@emotion的歌
播放愉快的歌	播放@emotion的歌
播放欢快的歌	播放@emotion的歌
播放快活的歌	播放@emotion的歌
播放欢乐的歌	播放@emotion的歌
播放欢愉的歌	播放@emotion的歌
播放喜气洋洋的歌	播放@emotion的歌
播放宣泄的歌	播放@emotion的歌
播放思念的歌	播放@emotion的歌
播放怀念的歌	播放@emotion的歌
播放想念的歌	播放@emotion的歌
播放惦念的歌	播放@emotion的歌
播放怀恋的歌	播放@emotion的歌
播放安静的歌	播放@emotion的歌
播放宁静的歌	播放@emotion的歌
播放静谧的歌	播放@emotion的歌
播放放松的歌	播放@emotion的歌
播放轻松的歌	播放@emotion的歌
播放舒缓心情的歌	播放@emotion的歌
播放放松心情的歌	播放@emotion的歌
播放缓解心情的歌	播放@emotion的歌
播放解压的歌	播放@emotion的歌
播放减压的歌	播放@emotion的歌
播放励志的歌	播放@emotion的歌
播放激励的歌	播放@emotion的歌
播放斗志昂扬的歌	播放@emotion的歌
播放积极向上的歌	播放@emotion的歌
播放正能量的歌	播放@emotion的歌
播放甜蜜的歌	播放@emotion的歌
播放幸福的歌	播放@emotion的歌
播放美满的歌	播放@emotion的歌
播放寂寞的歌	播放@emotion的歌
播放落寞的歌	播放@emotion的歌
播放孤独的歌	播放@emotion的歌
播放无聊的歌	播放@emotion的歌
播放伤心的歌	播放@emotion的歌
播放经典歌曲	播放@language歌曲
播放老歌	播放@language歌曲
播放ACG歌曲	播放@language歌曲
播放影视歌曲	播放@language歌曲
播放背景音乐歌曲	播放@language歌曲
播放乐器演奏的乐歌曲	播放@language歌曲
播放网络歌曲歌曲	播放@language歌曲
播放DJ歌曲	播放@language歌曲
播放KTV热歌歌曲	播放@language歌曲
播放中国风歌曲	播放@language歌曲
播放抒情歌曲	播放@language歌曲
播放现场音乐歌曲	播放@language歌曲
播放城市歌曲	播放@language歌曲
播放UP主歌曲	播放@language歌曲
播放儿歌	播放@language歌曲
播放佛教音乐歌曲	播放@language歌曲
播放古风歌曲	播放@language歌曲
播放英语歌曲	播放@language歌曲
播放国外歌曲	播放@language歌曲
播放外国歌曲	播放@language歌曲
播放外语歌曲	播放@language歌曲
播放英文歌曲	播放@language歌曲
播放英国歌曲	播放@language歌曲
播放欧美歌曲	播放@language歌曲
播放纯音乐	播放@language歌曲
播放西班牙语歌曲	播放@language歌曲
播放西班牙歌曲	播放@language歌曲
播放西班牙文歌曲	播放@language歌曲
播放西语歌曲	播放@language歌曲
播放德语歌曲	播放@language歌曲
播放德文歌曲	播放@language歌曲
播放德国歌曲	播放@language歌曲
播放国语歌曲	播放@language歌曲
播放国内歌曲	播放@language歌曲
播放汉语歌曲	播放@language歌曲
播放普通话歌曲	播放@language歌曲
播放中文歌曲	播放@language歌曲
播放华语歌曲	播放@language歌曲
播放大陆歌曲	播放@language歌曲
播放日语歌曲	播放@language歌曲
播放日本歌曲	播放@language歌曲
播放日文歌曲	播放@language歌曲
播放东瀛儿歌	播放@language歌曲
播放日本的歌曲	播放@language歌曲
播放日本话歌曲	播放@language歌曲
播放日本语歌曲	播放@language歌曲
播放法语歌曲	播放@language歌曲
播放法文歌曲	播放@language歌曲
播放法国歌曲	播放@language歌曲
播放意大利语歌曲	播放@language歌曲
播放意大利歌曲	播放@language歌曲
播放意大利文歌曲	播放@language歌曲
播放葡萄牙语歌曲	播放@language歌曲
播放葡萄牙歌曲	播放@language歌曲
播放葡萄牙文歌曲	播放@language歌曲
播放韩语歌曲	播放@language歌曲
播放韩国歌曲	播放@language歌曲
播放韩国语歌曲	播放@language歌曲
播放朝鲜语歌曲	播放@language歌曲
播放朝语歌曲	播放@language歌曲
播放韩文歌曲	播放@language歌曲
播放印度语歌曲	播放@language歌曲
播放印度歌曲	播放@language歌曲
播放俄语歌曲	播放@language歌曲
播放俄罗斯歌曲	播放@language歌曲
播放俄国歌曲	播放@language歌曲
播放俄文歌曲	播放@language歌曲
播放粤语歌曲	播放@language歌曲
播放广东歌曲	播放@language歌曲
播放澳门话歌曲	播放@language歌曲
播放广东话歌曲	播放@language歌曲
播放广府话歌曲	播放@language歌曲
播放海南话歌曲	播放@language歌曲
播放瑞典语歌曲	播放@language歌曲
播放瑞典歌曲	播放@language歌曲
播放瑞典文歌曲	播放@language歌曲
播放闽南语歌曲	播放@language歌曲
播放闽南话歌曲	播放@language歌曲
播放闽南歌曲	播放@language歌曲
播放福建歌曲	播放@language歌曲
播放拉丁语歌曲	播放@language歌曲
播放泰语歌曲	播放@language歌曲
播放泰文歌曲	播放@language歌曲
播放泰国歌曲	播放@language歌曲
播放女歌手唱的歌	播放@gender唱的歌
播放女孩唱的歌	播放@gender唱的歌
播放女孩儿唱的歌	播放@gender唱的歌
播放女孩子唱的歌	播放@gender唱的歌
播放小女孩唱的歌	播放@gender唱的歌
播放男歌手唱的歌	播放@gender唱的歌
播放男孩唱的歌	播放@gender唱的歌
播放男孩儿唱的歌	播放@gender唱的歌
播放男孩子唱的歌	播放@gender唱的歌
播放小男孩唱的歌	播放@gender唱的歌
播放组合唱的歌	播放@gender唱的歌
播放女神听的歌	播放@crowd听的歌
播放暖男听的歌	播放@crowd听的歌
播放男神听的歌	播放@crowd听的歌
播放上班族听的歌	播放@crowd听的歌
播放文艺青年听的歌	播放@crowd听的歌
播放文艺的歌	播放@crowd听的歌
播放90后听的歌	播放@crowd听的歌
播放70后听的歌	播放@crowd听的歌
播放00后听的歌	播放@crowd听的歌
播放80后听的歌	播放@crowd听的歌
播放兄弟听的歌	播放@crowd听的歌
播放儿童歌曲	播放@crowd听的歌
播放0-1岁听的歌	播放@age听的歌
播放0到1岁听的歌	播放@age听的歌
播放1-2岁听的歌	播放@age听的歌
播放1到2岁听的歌	播放@age听的歌
播放2-3岁听的歌	播放@age听的歌
播放2到3岁听的歌	播放@age听的歌
播放4-5岁听的歌	播放@age听的歌
播放4到5岁听的歌	播放@age听的歌
播放5-6岁听的歌	播放@age听的歌
播放5到6岁听的歌	播放@age听的歌
播放6岁以上听的歌	播放@age听的歌
播放六岁以上听的歌	播放@age听的歌
播放父亲节听的歌	播放@festival听的歌
播放母亲节听的歌	播放@festival听的歌
播放教师节听的歌	播放@festival听的歌
播放中秋节听的歌	播放@festival听的歌
播放重阳节听的歌	播放@festival听的歌
播放圣诞节听的歌	播放@festival听的歌
播放春节听的歌	播放@festival听的歌
播放元宵节听的歌	播放@festival听的歌
播放开车的时候听的歌	播放@scene的时候听的歌
播放驾驶的时候听的歌	播放@scene的时候听的歌
播放睡前歌曲	播放@scene歌曲
播放安神歌曲	播放@scene歌曲
播放临睡前歌曲	播放@scene歌曲
播放催眠曲	播放@scene歌曲
播放安眠曲	播放@scene歌曲
播放运动的时候听的歌	播放@scene的时候听的歌
播放活动的时候听的歌	播放@scene的时候听的歌
播放锻炼的时候听的歌	播放@scene的时候听的歌
播放跑步的时候听的歌	播放@scene的时候听的歌
播放慢跑的时候听的歌	播放@scene的时候听的歌
播放健身的时候听的歌	播放@scene的时候听的歌
播放旅行的时候听的歌	播放@scene的时候听的歌
播放旅游的时候听的歌	播放@scene的时候听的歌
播放出行的时候听的歌	播放@scene的时候听的歌
播放夜店里听的歌	播放@scene里听的歌
播放夜总会里听的歌	播放@scene里听的歌
播放聚会的时候听的歌	播放@scene的时候听的歌
播放派对的时候听的歌	播放@scene的时候听的歌
播放学习的时候听的歌	播放@scene的时候听的歌
播放念书的时候听的歌	播放@scene的时候听的歌
播放读书的时候听的歌	播放@scene的时候听的歌
播放思考的时候听的歌	播放@scene的时候听的歌
播放教室里听的歌	播放@scene的时候听的歌
播放工作的时候听的歌	播放@scene的时候听的歌
播放上班的时候听的歌	播放@scene的时候听的歌
播放坐班的时候听的歌	播放@scene的时候听的歌
播放约会的时候听的歌	播放@scene的时候听的歌
播放幽会的时候听的歌	播放@scene的时候听的歌
播放拍拖的时候听的歌	播放@scene的时候听的歌
播放谈恋爱的时候听的歌	播放@scene的时候听的歌
播放咖啡馆里听的歌	播放@scene里听的歌
播放咖啡厅里听的歌	播放@scene里听的歌
播放咖啡店里听的歌	播放@scene里听的歌
播放咖啡吧里听的歌	播放@scene里听的歌
播放跳舞的时候听的歌	播放@scene里听的歌
播放校园里听的歌	播放@scene里听的歌
播放学校里听的歌	播放@scene里听的歌
播放婚礼的时候听的歌	播放@scene的时候听的歌
播放结婚典礼的时候听的歌	播放@scene的时候听的歌
播放结婚仪式的时候听的歌	播放@scene的时候听的歌
唱一首薛之谦的歌	唱一首@singer的歌
唱一首周杰伦的歌	唱一首@singer的歌
唱一首BIGBANG的歌	唱一首@singer的歌
唱一首陈奕迅的歌	唱一首@singer的歌
唱一首林俊杰的歌	唱一首@singer的歌
唱一首Alan Walker的歌	唱一首@singer的歌
唱一首艾伦·沃克的歌	唱一首@singer的歌
唱一首李荣浩的歌	唱一首@singer的歌
唱一首TFBOYS的歌	唱一首@singer的歌
唱一首Maroon 5的歌	唱一首@singer的歌
我想听周杰伦的歌	我想听@singer的歌
我想听BIGBANG的歌	我想听@singer的歌
我想听陈奕迅的歌	我想听@singer的歌
我想听林俊杰的歌	我想听@singer的歌
我想听Alan Walker的歌	我想听@singer的歌
我想听艾伦·沃克的歌	我想听@singer的歌
我想听李荣浩的歌	我想听@singer的歌
我想听TFBOYS的歌	我想听@singer的歌
我想听Maroon 5的歌	我想听@singer的歌
我想听魔力红乐团的歌	我想听@singer的歌
唱首BIGBANG的歌	唱首@singer的歌
唱首陈奕迅的歌	唱首@singer的歌
唱首林俊杰的歌	唱首@singer的歌
唱首Alan Walker的歌	唱首@singer的歌
唱首艾伦·沃克的歌	唱首@singer的歌
唱首李荣浩的歌	唱首@singer的歌
唱首TFBOYS的歌	唱首@singer的歌
唱首Maroon 5的歌	唱首@singer的歌
唱首魔力红乐团的歌	唱首@singer的歌
唱首许嵩的歌	唱首@singer的歌
我要听陈奕迅的歌	我要听@singer的歌
我要听林俊杰的歌	我要听@singer的歌
我要听Alan Walker的歌	我要听@singer的歌
我要听艾伦·沃克的歌	我要听@singer的歌
我要听李荣浩的歌	我要听@singer的歌
我要听TFBOYS的歌	我要听@singer的歌
我要听Maroon 5的歌	我要听@singer的歌
我要听魔力红乐团的歌	我要听@singer的歌
我要听许嵩的歌	我要听@singer的歌
我要听邓紫棋的歌	我要听@singer的歌
给我放个林俊杰的歌	给我放个@singer的歌
给我放个Alan Walker的歌	给我放个@singer的歌
给我放个艾伦·沃克的歌	给我放个@singer的歌
给我放个李荣浩的歌	给我放个@singer的歌
给我放个TFBOYS的歌	给我放个@singer的歌
给我放个Maroon 5的歌	给我放个@singer的歌
给我放个魔力红乐团的歌	给我放个@singer的歌
给我放个许嵩的歌	给我放个@singer的歌
给我放个邓紫棋的歌	给我放个@singer的歌
给我放个张杰的歌	给我放个@singer的歌
唱个Alan Walker的歌	唱个@singer的歌
唱个艾伦·沃克的歌	唱个@singer的歌
唱个李荣浩的歌	唱个@singer的歌
唱个TFBOYS的歌	唱个@singer的歌
唱个Maroon 5的歌	唱个@singer的歌
唱个魔力红乐团的歌	唱个@singer的歌
唱个许嵩的歌	唱个@singer的歌
唱个邓紫棋的歌	唱个@singer的歌
唱个张杰的歌	唱个@singer的歌
唱个鹿晗的歌	唱个@singer的歌
艾伦·沃克的歌	@singer的歌
李荣浩的歌	@singer的歌
TFBOYS的歌	@singer的歌
Maroon 5的歌	@singer的歌
魔力红乐团的歌	@singer的歌
许嵩的歌	@singer的歌
邓紫棋的歌	@singer的歌
张杰的歌	@singer的歌
鹿晗的歌	@singer的歌
庄心妍的歌	@singer的歌
嗯你给我放个李荣浩的歌吧	嗯你给我放个@singer的歌吧
嗯你给我放个TFBOYS的歌吧	嗯你给我放个@singer的歌吧
嗯你给我放个Maroon 5的歌吧	嗯你给我放个@singer的歌吧
嗯你给我放个魔力红乐团的歌吧	嗯你给我放个@singer的歌吧
嗯你给我放个许嵩的歌吧	嗯你给我放个@singer的歌吧
嗯你给我放个邓紫棋的歌吧	嗯你给我放个@singer的歌吧
嗯你给我放个张杰的歌吧	嗯你给我放个@singer的歌吧
嗯你给我放个鹿晗的歌吧	嗯你给我放个@singer的歌吧
嗯你给我放个庄心妍的歌吧	嗯你给我放个@singer的歌吧
嗯你给我放个杨宗纬的歌吧	嗯你给我放个@singer的歌吧
来首TFBOYS的歌吧	来首@singer的歌吧
来首Maroon 5的歌吧	来首@singer的歌吧
来首魔力红乐团的歌吧	来首@singer的歌吧
来首许嵩的歌吧	来首@singer的歌吧
来首邓紫棋的歌吧	来首@singer的歌吧
来首张杰的歌吧	来首@singer的歌吧
来首鹿晗的歌吧	来首@singer的歌吧
来首庄心妍的歌吧	来首@singer的歌吧
来首杨宗纬的歌吧	来首@singer的歌吧
来首Justin Bieber的歌吧	来首@singer的歌吧
我想听一首Maroon 5的歌	我想听一首@singer的歌
我想听一首魔力红乐团的歌	我想听一首@singer的歌
我想听一首许嵩的歌	我想听一首@singer的歌
我想听一首邓紫棋的歌	我想听一首@singer的歌
我想听一首张杰的歌	我想听一首@singer的歌
我想听一首鹿晗的歌	我想听一首@singer的歌
我想听一首庄心妍的歌	我想听一首@singer的歌
我想听一首杨宗纬的歌	我想听一首@singer的歌
我想听一首Justin Bieber的歌	我想听一首@singer的歌
我想听一首贾斯汀·比伯的歌	我想听一首@singer的歌
播一个魔力红乐团的歌	播一个@singer的歌
播一个许嵩的歌	播一个@singer的歌
播一个邓紫棋的歌	播一个@singer的歌
播一个张杰的歌	播一个@singer的歌
播一个鹿晗的歌	播一个@singer的歌
播一个庄心妍的歌	播一个@singer的歌
播一个杨宗纬的歌	播一个@singer的歌
播一个Justin Bieber的歌	播一个@singer的歌
播一个贾斯汀·比伯的歌	播一个@singer的歌
播一个张碧晨的歌	播一个@singer的歌
播点许嵩的歌吧	播点@singer的歌吧
播点邓紫棋的歌吧	播点@singer的歌吧
播点张杰的歌吧	播点@singer的歌吧
播点鹿晗的歌吧	播点@singer的歌吧
播点庄心妍的歌吧	播点@singer的歌吧
播点杨宗纬的歌吧	播点@singer的歌吧
播点Justin Bieber的歌吧	播点@singer的歌吧
播点贾斯汀·比伯的歌吧	播点@singer的歌吧
播点张碧晨的歌吧	播点@singer的歌吧
播点华晨宇的歌吧	播点@singer的歌吧
放个邓紫棋的歌	放个@singer的歌
放个张杰的歌	放个@singer的歌
放个鹿晗的歌	放个@singer的歌
放个庄心妍的歌	放个@singer的歌
放个杨宗纬的歌	放个@singer的歌
放个Justin Bieber的歌	放个@singer的歌
放个贾斯汀·比伯的歌	放个@singer的歌
放个张碧晨的歌	放个@singer的歌
放个华晨宇的歌	放个@singer的歌
放个张学友的歌	放个@singer的歌
给我放个张杰唱的歌	给我放个@singer唱的歌
给我放个鹿晗唱的歌	给我放个@singer唱的歌
给我放个庄心妍唱的歌	给我放个@singer唱的歌
给我放个杨宗纬唱的歌	给我放个@singer唱的歌
给我放个Justin Bieber唱的歌	给我放个@singer唱的歌
给我放个贾斯汀·比伯唱的歌	给我放个@singer唱的歌
给我放个张碧晨唱的歌	给我放个@singer唱的歌
给我放个华晨宇唱的歌	给我放个@singer唱的歌
给我放个张学友唱的歌	给我放个@singer唱的歌
给我放个田馥甄唱的歌	给我放个@singer唱的歌
能给我放个鹿晗的歌么	能给我放个@singer的歌么
能给我放个庄心妍的歌么	能给我放个@singer的歌么
能给我放个杨宗纬的歌么	能给我放个@singer的歌么
能给我放个Justin Bieber的歌么	能给我放个@singer的歌么
能给我放个贾斯汀·比伯的歌么	能给我放个@singer的歌么
能给我放个张碧晨的歌么	能给我放个@singer的歌么
能给我放个华晨宇的歌么	能给我放个@singer的歌么
能给我放个张学友的歌么	能给我放个@singer的歌么
能给我放个田馥甄的歌么	能给我放个@singer的歌么
能给我放个RADWIMPS的歌么	能给我放个@singer的歌么
唱首庄心妍的歌来听一下	唱首@singer的歌来听一下
唱首杨宗纬的歌来听一下	唱首@singer的歌来听一下
唱首Justin Bieber的歌来听一下	唱首@singer的歌来听一下
唱首贾斯汀·比伯的歌来听一下	唱首@singer的歌来听一下
唱首张碧晨的歌来听一下	唱首@singer的歌来听一下
唱首华晨宇的歌来听一下	唱首@singer的歌来听一下
唱首张学友的歌来听一下	唱首@singer的歌来听一下
唱首田馥甄的歌来听一下	唱首@singer的歌来听一下
唱首RADWIMPS的歌来听一下	唱首@singer的歌来听一下
唱首萧敬腾的歌来听一下	唱首@singer的歌来听一下
啊唱首杨宗纬的歌	啊唱首@singer的歌
啊唱首Justin Bieber的歌	啊唱首@singer的歌
啊唱首贾斯汀·比伯的歌	啊唱首@singer的歌
啊唱首张碧晨的歌	啊唱首@singer的歌
啊唱首华晨宇的歌	啊唱首@singer的歌
啊唱首张学友的歌	啊唱首@singer的歌
啊唱首田馥甄的歌	啊唱首@singer的歌
啊唱首RADWIMPS的歌	啊唱首@singer的歌
啊唱首萧敬腾的歌	啊唱首@singer的歌
啊唱首那英的歌	啊唱首@singer的歌
哎唱首Justin Bieber的歌	哎唱首@singer的歌
哎唱首贾斯汀·比伯的歌	哎唱首@singer的歌
哎唱首张碧晨的歌	哎唱首@singer的歌
哎唱首华晨宇的歌	哎唱首@singer的歌
哎唱首张学友的歌	哎唱首@singer的歌
哎唱首田馥甄的歌	哎唱首@singer的歌
哎唱首RADWIMPS的歌	哎唱首@singer的歌
哎唱首萧敬腾的歌	哎唱首@singer的歌
哎唱首那英的歌	哎唱首@singer的歌
哎唱首王力宏的歌	哎唱首@singer的歌
宝宝要听贾斯汀·比伯的歌	宝宝要听@singer的歌
宝宝要听张碧晨的歌	宝宝要听@singer的歌
宝宝要听华晨宇的歌	宝宝要听@singer的歌
宝宝要听张学友的歌	宝宝要听@singer的歌
宝宝要听田馥甄的歌	宝宝要听@singer的歌
宝宝要听RADWIMPS的歌	宝宝要听@singer的歌
宝宝要听萧敬腾的歌	宝宝要听@singer的歌
宝宝要听那英的歌	宝宝要听@singer的歌
宝宝要听王力宏的歌	宝宝要听@singer的歌
宝宝要听张靓颖的歌	宝宝要听@singer的歌
播放热门榜单里的流行风格的歌	播放@billboard里的@style风格的歌
播放热门榜单里的原声风格的歌	播放@billboard里的@style风格的歌
播放热门榜单里的舞曲风格的歌	播放@billboard里的@style风格的歌
播放热门榜单里的世界音乐风格的歌	播放@billboard里的@style风格的歌
播放热门榜单里的R&B风格的歌	播放@billboard里的@style风格的歌
播放热门榜单里的民谣风格的歌	播放@billboard里的@style风格的歌
播放热门榜单里的轻音乐风格的歌	播放@billboard里的@style风格的歌
播放热门榜单里的摇滚风格的歌	播放@billboard里的@style风格的歌
播放热门榜单里的韩国流行风格的歌	播放@billboard里的@style风格的歌
播放热门榜单里的风格的歌	播放@billboard里的@style风格的歌
播放热门榜单里的嘻哈风格的歌	播放@billboard里的@style风格的歌
播放热门榜单里的新世纪风格的歌	播放@billboard里的@style风格的歌
播放热门榜单%#%新歌榜单里的原声风格的歌	播放@billboard里的@style风格的歌
播放热门榜单里的乡村风格的歌	播放@billboard里的@style风格的歌
播放热门榜单%#%新歌榜单里的流行风格的歌	播放@billboard里的@style风格的歌
播放热门榜单里的电子风格的歌	播放@billboard里的@style风格的歌
播放热门榜单里的中国传统风格的歌	播放@billboard里的@style风格的歌
播放热门榜单里的节奏布鲁斯风格的歌	播放@billboard里的@style风格的歌
播放热门榜单里的爵士风格的歌	播放@billboard里的@style风格的歌
播放热门榜单%#%新歌榜单里的风格的歌	播放@billboard里的@style风格的歌
播放热门榜单%#%新歌榜单里的舞曲风格的歌	播放@billboard里的@style风格的歌
播放热门榜单里的古典风格的歌	播放@billboard里的@style风格的歌
播放新歌榜单里的Pop 流行风格的歌	播放@billboard里的@style风格的歌
播放新歌榜单里的原声风格的歌	播放@billboard里的@style风格的歌
播放新歌榜单里的流行风格的歌	播放@billboard里的@style风格的歌
播放新歌榜单里的另类风格的歌	播放@billboard里的@style风格的歌
播放新歌榜单里的韩国流行风格的歌	播放@billboard里的@style风格的歌
播放新歌榜单里的摇滚风格的歌	播放@billboard里的@style风格的歌
播放新歌榜单里的舞曲风格的歌	播放@billboard里的@style风格的歌
播放新歌榜单里的嘻哈说唱风格的歌	播放@billboard里的@style风格的歌
播放新歌榜单里的民谣风格的歌	播放@billboard里的@style风格的歌
播放女人们的咖	播放@song
播放当我想你	播放@song
播放今生无缘来生	播放@song
播放失恋阵线	播放@song
播放很想说再见	播放@song
播放一个人想着一个	播放@song
播放可能的夜晚	播放@song
播放偏偏喜欢	播放@song
播放你瞒我	播放@song
播放经过的	播放@song
播放那片星空那片	播放@song
播放记事	播放@song
播放半小夜曲	播放@song
播放错是你痛是	播放@song
播放如同悲伤被下载了	播放@song
播放你一万年	播放@song
播放倍爽	播放@song
播放祝福兄弟	播放@song
播放我不够好	播放@song
播放爱我的人我爱的人	播放@song
播放你并不是真正的快乐	播放@song
播放我想大声的告诉你	播放@song
播放我们在一起	播放@song
播放东京太热	播放@song
播放最炫的民族风	播放@song
播放火光中唱歌	播放@song
播放兄弟永不变	播放@song
播放情歌王子	播放@song
播放请你不要在别人的肩上哭泣	播放@song
播放一动情心就痛	播放@song
播放别说再见	播放@song
播放刀斩逆徒	播放@song
播放断舍离	播放@song
播放海棠花	播放@song
播放国王乞丐	播放@song
播放国王和乞丐	播放@song
播放别那么骄傲	播放@song
播放贝加尔湖	播放@song
播放这么多年	播放@song
播放老男孩儿	播放@song
播放未完成的爱	播放@song
播放社会摇之混搭	播放@song
播放让全世界知道我	播放@song
播放贵妃醉酒	播放@song
播放近比较烦	播放@song
播放Aaron Carter唱的流行歌曲	播放@singer唱的@style歌曲
播放Adele唱的电子歌曲	播放@singer唱的@style歌曲
播放Adele唱的流行歌曲	播放@singer唱的@style歌曲
播放Alan Walker唱的舞曲歌曲	播放@singer唱的@style歌曲
播放Alan Walker和Iselin Solheim唱的嘻哈歌曲	播放@singer唱的@style歌曲
播放Avril Lavigne唱的嘻哈歌曲	播放@singer唱的@style歌曲
播放BEYOND唱的流行歌曲	播放@singer唱的@style歌曲
播放Beyond唱的摇滚歌曲	播放@singer唱的@style歌曲
播放BIGBANG唱的R&B歌曲	播放@singer唱的@style歌曲
播放BIGBANG唱的嘻哈歌曲	播放@singer唱的@style歌曲
播放BIGBANG唱的新世纪歌曲	播放@singer唱的@style歌曲
播放Block B唱的舞曲歌曲	播放@singer唱的@style歌曲
播放Bruno Mars唱的新世纪歌曲	播放@singer唱的@style歌曲
播放Carly Rae Jepsen唱的电子歌曲	播放@singer唱的@style歌曲
播放Colbie Caillat唱的电子歌曲	播放@singer唱的@style歌曲
播放Ed Sheeran唱的流行歌曲	播放@singer唱的@style歌曲
播放Ellie Goulding唱的轻音乐歌曲	播放@singer唱的@style歌曲
播放Fifth Harmony和KiD Ink唱的嘻哈歌曲	播放@singer唱的@style歌曲
播放Flo Rida唱的新世纪歌曲	播放@singer唱的@style歌曲
播放Flo Rida和Sage the Gemini唱的流行歌曲	播放@singer唱的@style歌曲
播放邓紫棋唱的原声歌曲	播放@singer唱的@style歌曲
播放GD X TAEYANG唱的电子歌曲	播放@singer唱的@style歌曲
播放G-DRAGON唱的R&B歌曲	播放@singer唱的@style歌曲
播放Jessie J和Ariana Grande唱的新世纪歌曲	播放@singer唱的@style歌曲
播放Katy Perry和Skip Marley唱的流行歌曲	播放@singer唱的@style歌曲
播放Kelly Clarkson唱的电子歌曲	播放@singer唱的@style歌曲
播放Kelly Clarkson唱的流行歌曲	播放@singer唱的@style歌曲
播放Lenka唱的R&B歌曲	播放@singer唱的@style歌曲
播放Lenka唱的嘻哈歌曲	播放@singer唱的@style歌曲
播放Linkin Park和Kiiara唱的流行歌曲	播放@singer唱的@style歌曲
播放Major Lazer和PARTYNEXTDOOR唱的电子歌曲	播放@singer唱的@style歌曲
播放Mariah Carey和YG唱的流行歌曲	播放@singer唱的@style歌曲
播放Mark Ronson和Bruno Mars唱的新世纪歌曲	播放@singer唱的@style歌曲
播放Maroon 5唱的R&B歌曲	播放@singer唱的@style歌曲
播放Maroon 5唱的新世纪歌曲	播放@singer唱的@style歌曲
播放Maroon 5和Future唱的流行歌曲	播放@singer唱的@style歌曲
播放Maroon 5和Big Sean唱的新世纪歌曲	播放@singer唱的@style歌曲
播放Maroon 5和Wiz Khalifa唱的新世纪歌曲	播放@singer唱的@style歌曲
播放MC康泽唱的流行歌曲	播放@singer唱的@style歌曲
播放Owl City和Carly Rae Jepsen唱的嘻哈歌曲	播放@singer唱的@style歌曲
播放Pitbull和Ke$ha唱的新世纪歌曲	播放@singer唱的@style歌曲
播放Rita黄汐源唱的流行歌曲	播放@singer唱的@style歌曲
播放Rixton唱的新世纪歌曲	播放@singer唱的@style歌曲
播放Ryan Gosling和Emma Stone唱的原声歌曲	播放@singer唱的@style歌曲
播放Sam Smith唱的流行歌曲	播放@singer唱的@style歌曲
播放Sia唱的R&B歌曲	播放@singer唱的@style歌曲
播放Stevie Wonder和Ariana Grande唱的流行歌曲	播放@singer唱的@style歌曲
播放TFBOYS唱的流行歌曲	播放@singer唱的@style歌曲
播放TFBOYS唱的乡村歌曲	播放@singer唱的@style歌曲
播放The Chainsmokers唱的舞曲歌曲	播放@singer唱的@style歌曲
播放The Chainsmokers和Coldplay唱的舞曲歌曲	播放@singer唱的@style歌曲
播放The Chainsmokers和Daya唱的R&B歌曲	播放@singer唱的@style歌曲
播放The Chainsmokers和Halsey唱的轻音乐歌曲	播放@singer唱的@style歌曲
播放The Downtown Fiction唱的嘻哈歌曲	播放@singer唱的@style歌曲
播放Trouble Maker唱的R&B歌曲	播放@singer唱的@style歌曲
播放Zion.T和G-DRAGON唱的节奏布鲁斯歌曲	播放@singer唱的@style歌曲
播放阿杜唱的流行歌曲	播放@singer唱的@style歌曲
播放蔡健雅唱的流行歌曲	播放@singer唱的@style歌曲
播放蔡旻佑唱的流行歌曲	播放@singer唱的@style歌曲
播放蔡依林唱的摇滚歌曲	播放@singer唱的@style歌曲
播放曾轶可唱的流行歌曲	播放@singer唱的@style歌曲
播放陈柏宇唱的流行歌曲	播放@singer唱的@style歌曲
播放陈鸿宇唱的流行歌曲	播放@singer唱的@style歌曲
播放陈粒唱的流行歌曲	播放@singer唱的@style歌曲
播放陈粒唱的民谣歌曲	播放@singer唱的@style歌曲
播放陈势安唱的乡村歌曲	播放@singer唱的@style歌曲
播放陈翔唱的流行歌曲	播放@singer唱的@style歌曲
播放陈翔唱的原声歌曲	播放@singer唱的@style歌曲
播放陈奕迅唱的流行歌曲	播放@singer唱的@style歌曲
播放戴佩妮唱的R&B歌曲	播放@singer唱的@style歌曲
播放邓紫棋唱的流行歌曲	播放@singer唱的@style歌曲
播放迪丽热巴唱的原声歌曲	播放@singer唱的@style歌曲
播放董贞唱的原声歌曲	播放@singer唱的@style歌曲
播放范玮琪唱的流行歌曲	播放@singer唱的@style歌曲
播放范玮琪唱的轻音乐歌曲	播放@singer唱的@style歌曲
播放范玮琪唱的原声歌曲	播放@singer唱的@style歌曲
播放范逸臣唱的流行歌曲	播放@singer唱的@style歌曲
播放飞儿乐团唱的流行歌曲	播放@singer唱的@style歌曲
播放葛林唱的流行歌曲	播放@singer唱的@style歌曲
播放古巨基唱的流行歌曲	播放@singer唱的@style歌曲
播放关喆唱的摇滚歌曲	播放@singer唱的@style歌曲
播放郭静唱的流行歌曲	播放@singer唱的@style歌曲
播放韩安旭唱的流行歌曲	播放@singer唱的@style歌曲
播放好妹妹乐队唱的摇滚歌曲	播放@singer唱的@style歌曲
播放胡歌唱的中国传统歌曲	播放@singer唱的@style歌曲
播放华晨宇唱的流行歌曲	播放@singer唱的@style歌曲
播放华晨宇唱的嘻哈歌曲	播放@singer唱的@style歌曲
播放华晨宇和杨宗纬唱的流行歌曲	播放@singer唱的@style歌曲
播放黄丽玲唱的轻音乐歌曲	播放@singer唱的@style歌曲
播放黄小琥唱的轻音乐歌曲	播放@singer唱的@style歌曲
播放黄雅莉唱的流行歌曲	播放@singer唱的@style歌曲
播放回音哥唱的流行歌曲	播放@singer唱的@style歌曲
播放贾斯汀·比伯唱的电子歌曲	播放@singer唱的@style歌曲
播放贾斯汀·比伯唱的嘻哈歌曲	播放@singer唱的@style歌曲
播放降央卓玛唱的流行歌曲	播放@singer唱的@style歌曲
播放金贵晟唱的流行歌曲	播放@singer唱的@style歌曲
播放凯蒂·佩里唱的世界音乐歌曲	播放@singer唱的@style歌曲
播放筷子兄弟唱的流行歌曲	播放@singer唱的@style歌曲
播放筷子兄弟唱的民谣歌曲	播放@singer唱的@style歌曲
播放赖伟锋唱的R&B歌曲	播放@singer唱的@style歌曲
播放老狼唱的民谣歌曲	播放@singer唱的@style歌曲
播放蕾哈娜唱的轻音乐歌曲	播放@singer唱的@style歌曲
播放李佳薇唱的流行歌曲	播放@singer唱的@style歌曲
播放李荣浩唱的流行歌曲	播放@singer唱的@style歌曲
播放李荣浩唱的民谣歌曲	播放@singer唱的@style歌曲
播放李荣浩唱的嘻哈歌曲	播放@singer唱的@style歌曲
播放李宇春唱的民谣歌曲	播放@singer唱的@style歌曲
播放李玉刚唱的流行歌曲	播放@singer唱的@style歌曲
播放李玉刚唱的中国传统歌曲	播放@singer唱的@style歌曲
播放林俊杰唱的流行歌曲	播放@singer唱的@style歌曲
播放林俊杰唱的中国传统歌曲	播放@singer唱的@style歌曲
播放林忆莲唱的民谣歌曲	播放@singer唱的@style歌曲
播放刘辰希唱的流行歌曲	播放@singer唱的@style歌曲
播放刘瑞琦唱的流行歌曲	播放@singer唱的@style歌曲
播放刘思涵唱的轻音乐歌曲	播放@singer唱的@style歌曲
播放刘惜君唱的原声歌曲	播放@singer唱的@style歌曲
播放鹿晗唱的流行歌曲	播放@singer唱的@style歌曲
播放鹿先森乐队唱的流行歌曲	播放@singer唱的@style歌曲
播放梅根·特瑞娜唱的R&B歌曲	播放@singer唱的@style歌曲
播放萌萌哒天团唱的流行歌曲	播放@singer唱的@style歌曲
播放梦然唱的古典歌曲	播放@singer唱的@style歌曲
播放莫文蔚唱的流行歌曲	播放@singer唱的@style歌曲
播放那英唱的流行歌曲	播放@singer唱的@style歌曲
播放南拳妈妈唱的流行歌曲	播放@singer唱的@style歌曲
播放南征北战唱的摇滚歌曲	播放@singer唱的@style歌曲
播放南征北战唱的原声歌曲	播放@singer唱的@style歌曲
播放彭佳慧唱的流行歌曲	播放@singer唱的@style歌曲
播放鹏泊唱的流行歌曲	播放@singer唱的@style歌曲
播放齐晨唱的流行歌曲	播放@singer唱的@style歌曲
播放齐一唱的摇滚歌曲	播放@singer唱的@style歌曲
播放青鸟飞鱼唱的轻音乐歌曲	播放@singer唱的@style歌曲
播放上海彩虹室内合唱团唱的流行歌曲	播放@singer唱的@style歌曲
播放水木年华唱的摇滚歌曲	播放@singer唱的@style歌曲
播放宋冬野唱的乡村歌曲	播放@singer唱的@style歌曲
播放宋冬野唱的摇滚歌曲	播放@singer唱的@style歌曲
播放宋孟君和格子兮唱的流行歌曲	播放@singer唱的@style歌曲
播放苏打绿唱的电子歌曲	播放@singer唱的@style歌曲
播放孙燕姿唱的流行歌曲	播放@singer唱的@style歌曲
播放谭维维唱的轻音乐歌曲	播放@singer唱的@style歌曲
播放陶喆唱的R&B歌曲	播放@singer唱的@style歌曲
播放田馥甄和井柏然唱的原声歌曲	播放@singer唱的@style歌曲
播放万茜和音频怪物唱的原声歌曲	播放@singer唱的@style歌曲
播放汪峰唱的流行歌曲	播放@singer唱的@style歌曲
播放王菲唱的流行歌曲	播放@singer唱的@style歌曲
播放王力宏唱的R&B歌曲	播放@singer唱的@style歌曲
播放王力宏唱的流行歌曲	播放@singer唱的@style歌曲
播放王力宏唱的民谣歌曲	播放@singer唱的@style歌曲
播放王力宏和卢巧音唱的世界音乐歌曲	播放@singer唱的@style歌曲
播放王若琳唱的爵士歌曲	播放@singer唱的@style歌曲
播放王童语唱的民谣歌曲	播放@singer唱的@style歌曲
播放韦礼安和郭静唱的原声歌曲	播放@singer唱的@style歌曲
播放吴克群唱的流行歌曲	播放@singer唱的@style歌曲
播放吴亦凡唱的电子歌曲	播放@singer唱的@style歌曲
播放香香唱的原声歌曲	播放@singer唱的@style歌曲
播放萧敬腾唱的流行歌曲	播放@singer唱的@style歌曲
播放萧敬腾唱的民谣歌曲	播放@singer唱的@style歌曲
播放萧敬腾唱的摇滚歌曲	播放@singer唱的@style歌曲
播放萧亚轩唱的流行歌曲	播放@singer唱的@style歌曲
播放徐誉滕唱的流行歌曲	播放@singer唱的@style歌曲
播放许茹芸唱的流行歌曲	播放@singer唱的@style歌曲
播放许嵩唱的流行歌曲	播放@singer唱的@style歌曲
播放许嵩唱的轻音乐歌曲	播放@singer唱的@style歌曲
播放许嵩和何曼婷唱的世界音乐歌曲	播放@singer唱的@style歌曲
播放许巍唱的民谣歌曲	播放@singer唱的@style歌曲
播放薛之谦唱的民谣歌曲	播放@singer唱的@style歌曲
播放杨坤唱的流行歌曲	播放@singer唱的@style歌曲
播放杨宗纬唱的流行歌曲	播放@singer唱的@style歌曲
播放杨宗纬和张碧晨唱的原声歌曲	播放@singer唱的@style歌曲
播放易烊千玺唱的电子歌曲	播放@singer唱的@style歌曲
播放郁可唯唱的原声歌曲	播放@singer唱的@style歌曲
播放郁可唯和张哲瀚唱的原声歌曲	播放@singer唱的@style歌曲
播放张碧晨唱的电子歌曲	播放@singer唱的@style歌曲
播放张碧晨唱的流行歌曲	播放@singer唱的@style歌曲
播放张杰唱的流行歌曲	播放@singer唱的@style歌曲
播放张杰唱的原声歌曲	播放@singer唱的@style歌曲
播放张敬轩唱的民谣歌曲	播放@singer唱的@style歌曲
播放张靓颖唱的流行歌曲	播放@singer唱的@style歌曲
播放张靓颖唱的原声歌曲	播放@singer唱的@style歌曲
播放张韶涵唱的流行歌曲	播放@singer唱的@style歌曲
播放张信哲唱的原声歌曲	播放@singer唱的@style歌曲
播放张学友唱的流行歌曲	播放@singer唱的@style歌曲
播放张学友唱的摇滚歌曲	播放@singer唱的@style歌曲
播放张宇唱的流行歌曲	播放@singer唱的@style歌曲
播放张宇唱的摇滚歌曲	播放@singer唱的@style歌曲
播放张芸京唱的流行歌曲	播放@singer唱的@style歌曲
播放赵雷唱的民谣歌曲	播放@singer唱的@style歌曲
播放郑智化唱的流行歌曲	播放@singer唱的@style歌曲
播放周柏豪和卫兰唱的流行歌曲	播放@singer唱的@style歌曲
播放周传雄唱的流行歌曲	播放@singer唱的@style歌曲
播放周蕙唱的流行歌曲	播放@singer唱的@style歌曲
播放周杰伦唱的R&B歌曲	播放@singer唱的@style歌曲
播放周杰伦唱的流行歌曲	播放@singer唱的@style歌曲
播放周杰伦唱的民谣歌曲	播放@singer唱的@style歌曲
播放周杰伦唱的轻音乐歌曲	播放@singer唱的@style歌曲
播放周杰伦唱的摇滚歌曲	播放@singer唱的@style歌曲
播放周深唱的原声歌曲	播放@singer唱的@style歌曲
播放庄心妍唱的轻音乐歌曲	播放@singer唱的@style歌曲
播放庄心妍唱的摇滚歌曲	播放@singer唱的@style歌曲
播放庄心妍和祁隆唱的流行歌曲	播放@singer唱的@style歌曲
播放阿杜的天黑	播放@singer的@song
播放阿里郎的忘记你太难	播放@singer的@song
播放阿木子心的小幸运	播放@singer的@song
播放安东阳的网络一线牵	播放@singer的@song
播放安苏羽的朋友还是没有爱情伟大	播放@singer的@song
播放巴桑拉姆的弦子	播放@singer的@song
播放白静晨的小幸运	播放@singer的@song
播放包师语的安和桥	播放@singer的@song
播放保剑锋的我是传奇	播放@singer的@song
播放本兮的我梦见我梦见我	播放@singer的@song
播放毕书尽的势在必行	播放@singer的@song
播放碧昂斯的Halo	播放@singer的@song
播放冰冰超人的好想你	播放@singer的@song
播放不要音乐的玫瑰-李雪萌	播放@singer的@song
播放蔡淳佳的女人们的咖啡	播放@singer的@song
播放蔡健雅的当我想你的时候	播放@singer的@song
播放蔡依林的Play我呸	播放@singer的@song
播放曹越的今生无缘来生再聚	播放@singer的@song
播放草蜢的失恋阵线联盟	播放@singer的@song
播放侧田的很想很想说再见	播放@singer的@song
播放曾沛慈的一个人想着一个人	播放@singer的@song
播放曾轶可的有可能的夜晚	播放@singer的@song
播放辰小弦的东风志	播放@singer的@song
播放陈百强的偏偏喜欢你	播放@singer的@song
播放陈柏宇的你瞒我瞒	播放@singer的@song
播放陈楚生的经过	播放@singer的@song
播放陈都灵的那片星空那片海	播放@singer的@song
播放陈鸿宇的别送我	播放@singer的@song
播放陈慧琳的记事本	播放@singer的@song
播放陈慧娴的月半小夜曲	播放@singer的@song
播放陈洁仪的心动	播放@singer的@song
播放陈明的幸福	播放@singer的@song
播放陈乔恩的Yes I Do	播放@singer的@song
播放陈瑞的错是你痛是我	播放@singer的@song
播放陈珊妮的如同悲伤被下载了两次	播放@singer的@song
播放陈势安的好爱好散	播放@singer的@song
播放陈伟霆的爱你一万年	播放@singer的@song
播放陈翔的十八季	播放@singer的@song
播放陈小春的独家记忆	播放@singer的@song
播放陈学冬的不再见	播放@singer的@song
播放陈雅森的很想对你说	播放@singer的@song
播放陈一发儿的童话镇	播放@singer的@song
播放陈一玲的解开魔咒	播放@singer的@song
播放陈奕迅的让我留在你身边	播放@singer的@song
播放成龙的功夫瑜伽	播放@singer的@song
播放程响的新娘不是我	播放@singer的@song
播放褚乔的我愿意	播放@singer的@song
播放崔健的假行僧	播放@singer的@song
播放崔子格的相思网	播放@singer的@song
播放大娇娇的进退两难	播放@singer的@song
播放大张伟的倍儿爽	播放@singer的@song
播放大哲的祝福你兄弟	播放@singer的@song
播放带泪的鱼的带泪的鱼	播放@singer的@song
播放戴墨的窒息	播放@singer的@song
播放戴佩妮的怎样	播放@singer的@song
播放戴荃的悟空	播放@singer的@song
播放单良的悟空	播放@singer的@song
播放单色凌的我想我不够好	播放@singer的@song
播放单小发的慢慢落单	播放@singer的@song
播放刀郎的西海情歌	播放@singer的@song
播放邓超的电台情歌	播放@singer的@song
播放邓丽君的我只在乎你	播放@singer的@song
播放迪克牛仔的爱我的人和我爱的人	播放@singer的@song
播放丁思忖的心裂	播放@singer的@song
播放丁毅的你不是真正的快乐	播放@singer的@song
播放杜雯媞的幻雨	播放@singer的@song
播放贰佰的嘿，抬头！	播放@singer的@song
播放樊凡的我想大声告诉你	播放@singer的@song
播放范玮琪的如果的事	播放@singer的@song
播放范晓萱的我要我们在一起	播放@singer的@song
播放方大同的特别的人	播放@singer的@song
播放飞儿乐团的Lydia	播放@singer的@song
播放飞轮海的只对你有感觉	播放@singer的@song
播放费玉清的一剪梅	播放@singer的@song
播放封茗囧菌的东京不太热	播放@singer的@song
播放封语的月亮代表我的心	播放@singer的@song
播放冯佳琪的门打开	播放@singer的@song
播放冯小刚的爱的代价	播放@singer的@song
播放凤凰传奇的最炫民族风	播放@singer的@song
播放高安的梦醉荷塘	播放@singer的@song
播放高夫的在火光中唱歌	播放@singer的@song
播放高进的还要	播放@singer的@song
播放高胜美的往事只能回味	播放@singer的@song
播放格子兮的异地恋	播放@singer的@song
播放葛林的兄弟永远不变	播放@singer的@song
播放古巨基的情歌王	播放@singer的@song
播放关诗敏的晴天	播放@singer的@song
播放关晓彤的带上月光上路	播放@singer的@song
播放关喆的想你的夜	播放@singer的@song
播放光良的请不要在别人的肩上哭泣	播放@singer的@song
播放郭静的下一个天亮	播放@singer的@song
播放海鸣威的你的承诺	播放@singer的@song
播放海生的情一动心就痛	播放@singer的@song
播放韩安旭的多幸运	播放@singer的@song
播放韩红的天亮了	播放@singer的@song
播放好妹妹乐队的不说再见	播放@singer的@song
播放郝琪力的刀怒斩逆徒	播放@singer的@song
播放何超与海胆仔的好女孩	播放@singer的@song
播放何炅的另一个自己	播放@singer的@song
播放何佳乐的舍离断	播放@singer的@song
播放何洁的你一定要幸福	播放@singer的@song
播放河图的倾尽天下	播放@singer的@song
播放贺一航的海棠花开	播放@singer的@song
播放黑鸭子的阿里郎	播放@singer的@song
播放后弦的娃娃脸	播放@singer的@song
播放呼可儿的爱过你	播放@singer的@song
播放胡歌的忘记时间	播放@singer的@song
播放胡夏的那些年	播放@singer的@song
播放胡杏儿的一刀了断	播放@singer的@song
播放胡彦斌的在一起	播放@singer的@song
播放花粥的我想带你去美丽的春天	播放@singer的@song
播放华晨宇的国王与乞丐	播放@singer的@song
播放黄博的快乐有你	播放@singer的@song
播放黄渤的不醉	播放@singer的@song
播放黄家强的无泪的遗憾	播放@singer的@song
播放黄龄的痒	播放@singer的@song
播放黄小琥的没那么简单	播放@singer的@song
播放黄晓明的光阴的故事	播放@singer的@song
播放黄勇的勇敢勇敢	播放@singer的@song
播放黄子韬的New day	播放@singer的@song
播放回音哥的寻找和你的未来	播放@singer的@song
播放霍建华的逍遥	播放@singer的@song
播放霍尊的卷珠帘	播放@singer的@song
播放吉克隽逸的彩色的黑	播放@singer的@song
播放贾乃亮的大王叫我来巡山	播放@singer的@song
播放贾征宇的漂洋过海来看你	播放@singer的@song
播放简弘亦的小缘家	播放@singer的@song
播放姜鹏的兄弟 想你了	播放@singer的@song
播放姜育恒的别让我一个人醉	播放@singer的@song
播放蒋敦豪的天空之城	播放@singer的@song
播放蒋蒋的聚散	播放@singer的@song
播放蒋雪儿的说你为什么爱我	播放@singer的@song
播放蒋志光的皇后大道东	播放@singer的@song
播放降央卓玛的西海情歌	播放@singer的@song
播放金贵晟的虹之间	播放@singer的@song
播放金海心的那么骄傲	播放@singer的@song
播放金美儿的阿里郎	播放@singer的@song
播放金玟岐的岁月神偷	播放@singer的@song
播放金南玲的逆流成河	播放@singer的@song
播放金润吉的阿里郎	播放@singer的@song
播放金莎的星月神话	播放@singer的@song
播放金志文的建筑师的梦想	播放@singer的@song
播放井柏然的健康动起来	播放@singer的@song
播放玖月奇迹的冰雪彩虹	播放@singer的@song
播放苦瓜先生的玫瑰	播放@singer的@song
播放筷子兄弟的老男孩	播放@singer的@song
播放赖伟锋的闹够了没有	播放@singer的@song
播放兰雨的你怎么看	播放@singer的@song
播放老狼的我要你	播放@singer的@song
播放冷漠的我爱你胜过你爱我	播放@singer的@song
播放黎明的今夜你会不会来	播放@singer的@song
播放李代沫的我是不是你最疼爱的人	播放@singer的@song
播放李行亮的愿得一人心	播放@singer的@song
播放李昊瀚的借他一个明天	播放@singer的@song
播放李佳薇的煎熬	播放@singer的@song
播放李健的贝加尔湖畔	播放@singer的@song
播放李俊杰的这么多年了	播放@singer的@song
播放李克勤的红日	播放@singer的@song
播放李美熹的漂洋过海来看你	播放@singer的@song
播放李娜的阿里郎	播放@singer的@song
播放李琦的金玉良缘	播放@singer的@song
播放李荣浩的不将就	播放@singer的@song
播放李圣杰的手放开	播放@singer的@song
播放李炜的诺	播放@singer的@song
播放李小璐的Worth It	播放@singer的@song
播放李晓杰的Hello 大叔	播放@singer的@song
播放李易峰的请跟我联络	播放@singer的@song
播放李翊君的雨蝶	播放@singer的@song
播放李宇春的和你一样	播放@singer的@song
播放李玉刚的新贵妃醉酒	播放@singer的@song
播放李志的天空之城	播放@singer的@song
播放李治廷的九月鹰飞	播放@singer的@song
播放李宗盛的给自己的歌	播放@singer的@song
播放励阳的你不知道的事	播放@singer的@song
播放梁博的北京北京	播放@singer的@song
播放梁朝伟的十年	播放@singer的@song
播放梁剑东的家驹	播放@singer的@song
播放梁静茹的暖暖	播放@singer的@song
播放梁心颐的不遇见	播放@singer的@song
播放梁咏琪的短发	播放@singer的@song
播放廖伟志的穿过前男友胸前的箭	播放@singer的@song
播放林峯的爱在记忆中找你	播放@singer的@song
播放林俊杰的末班车	播放@singer的@song
播放林隆璇的你那么爱他	播放@singer的@song
播放林忆莲的盛夏光年	播放@singer的@song
播放林宥嘉的让世界毁灭	播放@singer的@song
播放林志炫的Writing's On The Wall	播放@singer的@song
播放刘德华的练习	播放@singer的@song
播放刘欢的唱我的歌	播放@singer的@song
播放刘珂矣的花笺	播放@singer的@song
播放刘明湘的漂洋过海来看你	播放@singer的@song
播放刘瑞琦的每次和你走在路上都会看见一只喵	播放@singer的@song
播放刘若英的后来	播放@singer的@song
播放刘思涵的走在冷风中	播放@singer的@song
播放刘涛的最好的时光	播放@singer的@song
播放刘维的小丑的烦恼	播放@singer的@song
播放刘惜君的线	播放@singer的@song
播放刘一尘的别说爱	播放@singer的@song
播放刘亦菲的还在这里	播放@singer的@song
播放刘雨潼的等风来	播放@singer的@song
播放刘玥的未完成的爱恋	播放@singer的@song
播放六月的社会摇之混搭神曲	播放@singer的@song
播放六哲的让全世界知道我爱你	播放@singer的@song
播放龙飞的爱上爱情爱上你	播放@singer的@song
播放龙井说唱的归	播放@singer的@song
播放龙梅子的谁都不要说分手	播放@singer的@song
播放鹿晗的敢 Roleplay	播放@singer的@song
播放罗大佑的童年	播放@singer的@song
播放马博的菊花爆满山	播放@singer的@song
播放马頔的最后一次看着你	播放@singer的@song
播放马天宇的该死的温柔	播放@singer的@song
播放马旭东的再见的理由	播放@singer的@song
播放梅艳芳的一生爱你千百回	播放@singer的@song
播放门丽的女人不要哭	播放@singer的@song
播放萌萌哒天团的今生梦牵	播放@singer的@song
播放蒙面哥的让它说去	播放@singer的@song
播放孟庆华的大西厢	播放@singer的@song
播放孟庭苇的没有情人的情人节	播放@singer的@song
播放梦然的没有你陪伴真的好孤单	播放@singer的@song
播放明道的再次相信	播放@singer的@song
播放莫文蔚的阴天	播放@singer的@song
播放莫小娘的你没法激怒我	播放@singer的@song
播放慕容晓晓的红尘有缘	播放@singer的@song
播放那英的征服	播放@singer的@song
播放南拳妈妈的下雨天	播放@singer的@song
播放南征北战的我们的热血传奇	播放@singer的@song
播放尼玛泽仁·亚东的弦子	播放@singer的@song
播放牛奶咖啡的明天，你好	播放@singer的@song
播放欧豪的放心去飞	播放@singer的@song
播放排骨教主的狐言	播放@singer的@song
播放潘玮柏的快乐崇拜	播放@singer的@song
播放庞龙的兄弟抱一下	播放@singer的@song
播放彭佳慧的相见恨晚	播放@singer的@song
播放鹏泊的啷个哩个啷	播放@singer的@song
播放朴树的平凡之路	播放@singer的@song
播放戚薇的如果爱忘了	播放@singer的@song
播放齐晨的咱们结婚吧	播放@singer的@song
播放齐秦的广岛之恋	播放@singer的@song
播放齐一的这个年纪	播放@singer的@song
播放祁隆的等你等了那么久	播放@singer的@song
播放乔任梁的燃烧	播放@singer的@song
播放青蛙乐队的小跳蛙	播放@singer的@song
播放邱永传的十二年	播放@singer的@song
播放曲婉婷的Jar Of Love	播放@singer的@song
播放权赫的摩天轮	播放@singer的@song
播放任然的三生	播放@singer的@song
播放任素汐的我要你	播放@singer的@song
播放任贤齐的不在乎	播放@singer的@song
播放容祖儿的挥着翅膀的女孩	播放@singer的@song
播放阮经天的爱过	播放@singer的@song
播放沙宝亮的袖手旁观	播放@singer的@song
播放少司命的瑶琴	播放@singer的@song
播放石头的雨花石	播放@singer的@song
播放双笙的镜花水月	播放@singer的@song
播放水木年华的青春再见	播放@singer的@song
播放宋冬野的安和桥	播放@singer的@song
播放宋孟君的王者荣耀	播放@singer的@song
播放苏打绿的我好想你	播放@singer的@song
播放苏勒亚其其格的歌在飞	播放@singer的@song
播放苏立生的流着泪说分手	播放@singer的@song
播放苏芮的牵手	播放@singer的@song
播放苏运莹的野子	播放@singer的@song
播放孙凰的胡歌	播放@singer的@song
播放孙露的痛快人生	播放@singer的@song
播放孙楠的美丽的神话	播放@singer的@song
播放孙燕姿的遇见	播放@singer的@song
播放孙子涵的唐人	播放@singer的@song
播放谭晶的乖乖	播放@singer的@song
播放谭维维的如果有来生	播放@singer的@song
播放谭咏麟的一生中最爱	播放@singer的@song
播放汤潮的美了美了	播放@singer的@song
播放唐古的你偷空了我的心	播放@singer的@song
播放唐海兵的九世轮回篇空拍	播放@singer的@song
播放糖糖的一曲神摇	播放@singer的@song
播放逃跑计划的夜空中最亮的星	播放@singer的@song
播放陶喆的就是爱你	播放@singer的@song
播放田馥甄的美女与野兽	播放@singer的@song
播放铁竹堂的能不能	播放@singer的@song
播放童可可的一种感觉	播放@singer的@song
播放屠洪刚的你	播放@singer的@song
播放万万小宇宙的Microcosm	播放@singer的@song
播放汪晨蕊的友情岁月	播放@singer的@song
播放汪东城的在你离开那一天	播放@singer的@song
播放汪峰的当我想你的时候	播放@singer的@song
播放汪涵的凡人歌	播放@singer的@song
播放汪苏泷的不分手的恋爱	播放@singer的@song
播放王菲的你在终点等我	播放@singer的@song
播放王杰的不浪漫罪名	播放@singer的@song
播放王俊凯的再见	播放@singer的@song
播放王力宏的依然爱你	播放@singer的@song
播放王若琳的有你的快乐	播放@singer的@song
播放王思远的她	播放@singer的@song
播放王童语的丫头	播放@singer的@song
播放王菀之的友谊的小船	播放@singer的@song
播放王笑文的耿耿于怀	播放@singer的@song
播放王心凌的当你	播放@singer的@song
播放王绎龙的电音之王	播放@singer的@song
播放王媛渊的蝶缘	播放@singer的@song
播放王铮亮的我不会一个人	播放@singer的@song
播放王筝的没有人比我更爱你	播放@singer的@song
播放王子文的时光诛仙	播放@singer的@song
播放王祖蓝的王牌对王牌	播放@singer的@song
播放望海高歌的时光不老我们不散	播放@singer的@song
播放威仔的重复的伤	播放@singer的@song
播放卫兰的大哥	播放@singer的@song
播放魏晨的不变	播放@singer的@song
播放魏新雨的恋人心	播放@singer的@song
播放温岚的屋顶	播放@singer的@song
播放乌兰图雅的海市蜃楼	播放@singer的@song
播放吴克群的奇怪的你	播放@singer的@song
播放吴莫愁的你就是梦想	播放@singer的@song
播放吴奇隆的流恋	播放@singer的@song
播放吴若希的越难越爱	播放@singer的@song
播放吴亦凡的从此以后	播放@singer的@song
播放吴雨霏的明知做戏	播放@singer的@song
播放五月天的拥抱	播放@singer的@song
播放伍佰的挪威的森林	播放@singer的@song
播放伍华的戒不掉的爱	播放@singer的@song
播放兮雅的今天你嗨了么	播放@singer的@song
播放夏婉安的倾尽所有	播放@singer的@song
播放弦子的爱情呼救999	播放@singer的@song
播放肖亮的爱的记忆你曾来过	播放@singer的@song
播放萧煌奇的有多少爱可以重来	播放@singer的@song
播放萧敬腾的怎么说我不爱你	播放@singer的@song
播放萧全的社会摇	播放@singer的@song
播放萧亚轩的突然想起你	播放@singer的@song
播放小峰峰的现实派悲伤	播放@singer的@song
播放小虎队的爱	播放@singer的@song
播放谭冰尧的当我唱起这首歌	播放@singer的@song
播放小可的社会摇	播放@singer的@song
播放小七的Hi 男朋友	播放@singer的@song
播放小曲儿的上邪	播放@singer的@song
播放小沈阳的男人歌	播放@singer的@song
播放小右的迟到的歌	播放@singer的@song
播放谢安琪的喜帖街	播放@singer的@song
播放谢帝的明天不上班	播放@singer的@song
播放谢娜的忽然之间	播放@singer的@song
播放谢霆锋的回甘	播放@singer的@song
播放新街口组合的Marry Me2020	播放@singer的@song
播放信乐团的假如	播放@singer的@song
播放星弟的结	播放@singer的@song
播放熊天平的你的眼睛	播放@singer的@song
播放徐歌阳的一万次悲伤	播放@singer的@song
播放徐佳莹的身骑白马	播放@singer的@song
播放徐良的后会无期	播放@singer的@song
播放徐薇的知足	播放@singer的@song
播放徐誉滕的等一分钟	播放@singer的@song
播放徐子洋的等不到的期待	播放@singer的@song
播放许飞的我要的飞翔	播放@singer的@song
播放许佳慧的预谋	播放@singer的@song
播放许美静的都是夜归人	播放@singer的@song
播放许茹芸的独角戏	播放@singer的@song
播放许嵩的素颜	播放@singer的@song
播放许廷铿的知己	播放@singer的@song
播放许巍的蓝莲花	播放@singer的@song
播放许一鸣的我如此爱你	播放@singer的@song
播放许艺娜的阿里郎	播放@singer的@song
播放许志安的慢慢	播放@singer的@song
播放薛凯琪的复刻回忆	播放@singer的@song
播放薛之谦的绅士	播放@singer的@song
播放牙牙乐的秋殇别恋	播放@singer的@song
播放严艺丹的三寸天堂	播放@singer的@song
播放颜小健的一不小心	播放@singer的@song
播放阳逸晨的别爱	播放@singer的@song
播放杨丞琳的王见王	播放@singer的@song
播放杨栋梁的我的心在海对面	播放@singer的@song
播放杨炅翰的最好的我们	播放@singer的@song
播放杨坤的空城	播放@singer的@song
播放杨幂的爱的供养	播放@singer的@song
播放杨千嬅的小城大事	播放@singer的@song
播放杨烁的金苹果	播放@singer的@song
播放杨洋的微微一笑很倾城	播放@singer的@song
播放杨梓文祺的亲爱的你听见了吗	播放@singer的@song
播放杨宗纬的洋葱	播放@singer的@song
播放姚贝娜的随它吧	播放@singer的@song
播放艺涛的中国V5	播放@singer的@song
播放易烊千玺的你说	播放@singer的@song
播放银临的锦鲤抄	播放@singer的@song
播放印子月的冷风里	播放@singer的@song
播放泳儿的你的承诺	播放@singer的@song
播放忧欢派对的新年快乐	播放@singer的@song
播放虞姬的皖	播放@singer的@song
播放羽泉的我可以抱你吗	播放@singer的@song
播放雨柔的守望心与心的约定	播放@singer的@song
播放雨宗林的逝去的爱情和青春	播放@singer的@song
播放庾澄庆的情非得已	播放@singer的@song
播放郁可唯的思慕	播放@singer的@song
播放袁成杰的想我了吗	播放@singer的@song
播放岳云鹏的送情郎	播放@singer的@song
播放云菲菲的殇雪	播放@singer的@song
播放澤野弘之的aLIEz	播放@singer的@song
播放张碧晨的It's Love	播放@singer的@song
播放张冬玲的我在红尘中遇见你	播放@singer的@song
播放张国荣的倩女幽魂	播放@singer的@song
播放张赫宣的我们不该这样的	播放@singer的@song
播放张惠妹的我可以抱你吗	播放@singer的@song
播放张杰的哥哥	播放@singer的@song
播放张婧懿的玫瑰	播放@singer的@song
播放张敬轩的吻得太逼真	播放@singer的@song
播放张磊的暖人	播放@singer的@song
播放张靓颖的思美人	播放@singer的@song
播放张韶涵的淋雨一直走	播放@singer的@song
播放张思思的我爱他	播放@singer的@song
播放张玮的High歌	播放@singer的@song
播放张峡浩的One Day	播放@singer的@song
播放张小七的单眼皮女生	播放@singer的@song
播放张晓星的唱给你听	播放@singer的@song
播放张信哲的过火	播放@singer的@song
播放张学友的慢慢	播放@singer的@song
播放张一山的那就这样吧	播放@singer的@song
播放张艺兴的奶爸天团洗脑歌	播放@singer的@song
播放张宇的给你们	播放@singer的@song
播放张雨生的大海	播放@singer的@song
播放张芸京的偏爱	播放@singer的@song
播放张智霖的天梯	播放@singer的@song
播放赵骏的你就不要想起我	播放@singer的@song
播放赵雷的三十岁的女人	播放@singer的@song
播放赵莉的阿里郎	播放@singer的@song
播放赵露的母亲楼	播放@singer的@song
播放赵鑫的好兄弟	播放@singer的@song
播放赵照的启程	播放@singer的@song
播放郑希怡的最近比较烦	播放@singer的@song
播放郑欣宜的上心	播放@singer的@song
播放郑秀文的唉声叹气	播放@singer的@song
播放郑伊健的热血燃烧	播放@singer的@song
播放郑怡的结束	播放@singer的@song
播放郑源的包容	播放@singer的@song
播放郑智化的水手	播放@singer的@song
播放郑中基的无赖	播放@singer的@song
播放至上励合的棉花糖	播放@singer的@song
播放钟欣潼的完整爱	播放@singer的@song
播放周柏豪的近在千里	播放@singer的@song
播放周笔畅的笔记	播放@singer的@song
播放周传雄的黄昏	播放@singer的@song
播放周华健的刀剑如梦	播放@singer的@song
播放周杰伦的告白气球	播放@singer的@song
播放周深的回声	播放@singer的@song
播放朱俐静的安静	播放@singer的@song
播放朱强的车站	播放@singer的@song
播放庄心妍的爱囚	播放@singer的@song
播放卓依婷的明天会更好	播放@singer的@song
播放蔡淳佳的女人们的咖	播放@singer的@song
播放蔡健雅的当我想你	播放@singer的@song
播放曹越的今生无缘来生	播放@singer的@song
播放草蜢的失恋阵线	播放@singer的@song
播放侧田的很想说再见	播放@singer的@song
播放曾沛慈的一个人想着一个	播放@singer的@song
播放曾轶可的可能的夜晚	播放@singer的@song
播放陈百强的偏偏喜欢	播放@singer的@song
播放陈柏宇的你瞒我	播放@singer的@song
播放陈楚生的经过的	播放@singer的@song
播放陈都灵的那片星空那片	播放@singer的@song
播放陈慧琳的记事	播放@singer的@song
播放陈慧娴的半小夜曲	播放@singer的@song
播放陈瑞的错是你痛是	播放@singer的@song
播放陈珊妮的如同悲伤被下载了	播放@singer的@song
播放陈伟霆的你一万年	播放@singer的@song
播放大张伟的倍爽	播放@singer的@song
播放大哲的祝福兄弟	播放@singer的@song
播放单色凌的我不够好	播放@singer的@song
播放迪克牛仔的爱我的人我爱的人	播放@singer的@song
播放丁毅的你并不是真正的快乐	播放@singer的@song
播放樊凡的我想大声的告诉你	播放@singer的@song
播放范晓萱的我们在一起	播放@singer的@song
播放封茗囧菌的东京太热	播放@singer的@song
播放凤凰传奇的最炫的民族风	播放@singer的@song
播放高夫的火光中唱歌	播放@singer的@song
播放葛林的兄弟永不变	播放@singer的@song
播放古巨基的情歌王子	播放@singer的@song
播放光良的请你不要在别人的肩上哭泣	播放@singer的@song
播放海生的一动情心就痛	播放@singer的@song
播放好妹妹乐队的别说再见	播放@singer的@song
播放郝琪力的刀斩逆徒	播放@singer的@song
播放何佳乐的断舍离	播放@singer的@song
播放Adele唱的Rolling In The Deep专辑里的歌	播放@singer唱的@album专辑里的歌
播放Adele唱的25专辑里的歌	播放@singer唱的@album专辑里的歌
播放Alan Walker唱的Routine专辑里的歌	播放@singer唱的@album专辑里的歌
播放Alan Walker和Iselin Solheim唱的Faded专辑里的歌	播放@singer唱的@album专辑里的歌
播放Avril Lavigne唱的The Best Damn Thing/Under My Skin专辑里的歌	播放@singer唱的@album专辑里的歌
播放Beyond唱的BEYOND IV专辑里的歌	播放@singer唱的@album专辑里的歌
播放BEYOND唱的华纳23周年纪念精选系列专辑里的歌	播放@singer唱的@album专辑里的歌
播放Block B唱的YESTERDAY专辑里的歌	播放@singer唱的@album专辑里的歌
播放Bruno Mars唱的Unorthodox Jukebox专辑里的歌	播放@singer唱的@album专辑里的歌
播放Carly Rae Jepsen唱的Call Me Maybe专辑里的歌	播放@singer唱的@album专辑里的歌
播放Charlie Puth和Selena Gomez唱的Nine Track Mind专辑里的歌	播放@singer唱的@album专辑里的歌
播放Colbie Caillat唱的Gypsy Heart Side A专辑里的歌	播放@singer唱的@album专辑里的歌
播放Ed Sheeran唱的Shape of You专辑里的歌	播放@singer唱的@album专辑里的歌
播放Fifth Harmony和KiD Ink唱的Reflection专辑里的歌	播放@singer唱的@album专辑里的歌
播放Flo Rida唱的Whistle专辑里的歌	播放@singer唱的@album专辑里的歌
播放Flo Rida和Sage the Gemini唱的Game Time专辑里的歌	播放@singer唱的@album专辑里的歌
播放邓紫棋唱的光年之外专辑里的歌	播放@singer唱的@album专辑里的歌
播放GD X TAEYANG唱的GOOD BOY专辑里的歌	播放@singer唱的@album专辑里的歌
播放Jessie J和Ariana Grande唱的Bang Bang专辑里的歌	播放@singer唱的@album专辑里的歌
播放Katy Perry和Skip Marley唱的Chained To The Rhythm专辑里的歌	播放@singer唱的@album专辑里的歌
播放Kelly Clarkson唱的Stronger专辑里的歌	播放@singer唱的@album专辑里的歌
播放Kelly Clarkson唱的Breakaway专辑里的歌	播放@singer唱的@album专辑里的歌
播放La La Land Cast唱的La La Land专辑里的歌	播放@singer唱的@album专辑里的歌
播放Lenka唱的Lenka专辑里的歌	播放@singer唱的@album专辑里的歌
播放Linkin Park和Kiiara唱的Heavy专辑里的歌	播放@singer唱的@album专辑里的歌
播放Major Lazer和PARTYNEXTDOOR唱的Run Up专辑里的歌	播放@singer唱的@album专辑里的歌
播放Mariah Carey和YG唱的I Don't专辑里的歌	播放@singer唱的@album专辑里的歌
播放Mark Ronson和Bruno Mars唱的Uptown Special专辑里的歌	播放@singer唱的@album专辑里的歌
播放Maroon 5唱的V专辑里的歌	播放@singer唱的@album专辑里的歌
播放Maroon 5唱的Animals专辑里的歌	播放@singer唱的@album专辑里的歌
播放Maroon 5和Future唱的Cold专辑里的歌	播放@singer唱的@album专辑里的歌
播放Maroon 5和Big Sean唱的Maps专辑里的歌	播放@singer唱的@album专辑里的歌
播放Maroon 5和Wiz Khalifa唱的Payphone专辑里的歌	播放@singer唱的@album专辑里的歌
播放MC康泽唱的大话西游专辑里的歌	播放@singer唱的@album专辑里的歌
播放One Direction唱的What Makes You Beautiful专辑里的歌	播放@singer唱的@album专辑里的歌
播放Owl City和Carly Rae Jepsen唱的Good Time专辑里的歌	播放@singer唱的@album专辑里的歌
播放Pitbull和Ke$ha唱的Timber专辑里的歌	播放@singer唱的@album专辑里的歌
播放Rita黄汐源唱的火花专辑里的歌	播放@singer唱的@album专辑里的歌
播放Rixton唱的Me And My Broken Heart专辑里的歌	播放@singer唱的@album专辑里的歌
播放Ryan Gosling和Emma Stone唱的La La Land专辑里的歌	播放@singer唱的@album专辑里的歌
播放Sam Smith唱的2015 GRAMMY Nominees专辑里的歌	播放@singer唱的@album专辑里的歌
播放Sia唱的Cheap Thrills专辑里的歌	播放@singer唱的@album专辑里的歌
播放Stevie Wonder和Ariana Grande唱的Faith专辑里的歌	播放@singer唱的@album专辑里的歌
播放TFBOYS唱的大梦想家专辑里的歌	播放@singer唱的@album专辑里的歌
播放TFBOYS唱的不完美小孩专辑里的歌	播放@singer唱的@album专辑里的歌
播放TFBOYS唱的萤火专辑里的歌	播放@singer唱的@album专辑里的歌
播放TFBOYS唱的青春修炼手册专辑里的歌	播放@singer唱的@album专辑里的歌
播放TFBOYS唱的魔法城堡专辑里的歌	播放@singer唱的@album专辑里的歌
播放The Chainsmokers唱的Paris专辑里的歌	播放@singer唱的@album专辑里的歌
播放The Chainsmokers和Coldplay唱的Something Just Like This专辑里的歌	播放@singer唱的@album专辑里的歌
播放The Chainsmokers和Daya唱的Don't Let Me Down专辑里的歌	播放@singer唱的@album专辑里的歌
播放The Chainsmokers和Halsey唱的Closer专辑里的歌	播放@singer唱的@album专辑里的歌
播放The Downtown Fiction唱的Best I Never Had专辑里的歌	播放@singer唱的@album专辑里的歌
播放Wiz Khalifa和Charlie Puth唱的Furious 7专辑里的歌	播放@singer唱的@album专辑里的歌
播放Zion.T和G-DRAGON唱的OO专辑里的歌	播放@singer唱的@album专辑里的歌
播放阿杜唱的天黑专辑里的歌	播放@singer唱的@album专辑里的歌
播放蔡健雅唱的T-time 新歌 精选专辑里的歌	播放@singer唱的@album专辑里的歌
播放蔡健雅唱的陌生人专辑里的歌	播放@singer唱的@album专辑里的歌
播放蔡旻佑唱的19专辑里的歌	播放@singer唱的@album专辑里的歌
播放蔡依林唱的城堡专辑里的歌	播放@singer唱的@album专辑里的歌
播放曾轶可唱的一只猫的旅行专辑里的歌	播放@singer唱的@album专辑里的歌
播放陈柏宇唱的Close Up专辑里的歌	播放@singer唱的@album专辑里的歌
播放陈鸿宇唱的浓烟下的诗歌电台专辑里的歌	播放@singer唱的@album专辑里的歌
播放陈粒唱的小梦大半专辑里的歌	播放@singer唱的@album专辑里的歌
播放陈粒唱的戏台专辑里的歌	播放@singer唱的@album专辑里的歌
播放陈粒唱的如也专辑里的歌	播放@singer唱的@album专辑里的歌
播放陈势安唱的天后专辑里的歌	播放@singer唱的@album专辑里的歌
播放陈翔唱的MY STAGE 我的舞台专辑里的歌	播放@singer唱的@album专辑里的歌
播放陈翔唱的轻狂专辑里的歌	播放@singer唱的@album专辑里的歌
播放陈奕迅唱的不想放手专辑里的歌	播放@singer唱的@album专辑里的歌
播放戴佩妮唱的怎样专辑里的歌	播放@singer唱的@album专辑里的歌
播放邓紫棋唱的Xposed专辑里的歌	播放@singer唱的@album专辑里的歌
播放邓紫棋唱的The Best of G.E.M. 2008-2012专辑里的歌	播放@singer唱的@album专辑里的歌
播放迪丽热巴唱的漂亮的李慧珍 电视剧原声带专辑里的歌	播放@singer唱的@album专辑里的歌
播放董贞唱的三生三世十里桃花 电视剧原声带专辑里的歌	播放@singer唱的@album专辑里的歌
播放范玮琪唱的我们的纪念日专辑里的歌	播放@singer唱的@album专辑里的歌
播放范玮琪唱的真善美专辑里的歌	播放@singer唱的@album专辑里的歌
播放范玮琪唱的那个静默的阳光午后专辑里的歌	播放@singer唱的@album专辑里的歌
播放范玮琪唱的最初的梦想专辑里的歌	播放@singer唱的@album专辑里的歌
播放范逸臣唱的不说出的温柔专辑里的歌	播放@singer唱的@album专辑里的歌
播放飞儿乐团唱的F.I.R.飞儿乐团专辑里的歌	播放@singer唱的@album专辑里的歌
播放葛林唱的林中鸟专辑里的歌	播放@singer唱的@album专辑里的歌
播放古巨基唱的最爱专辑里的歌	播放@singer唱的@album专辑里的歌
播放古巨基唱的劲歌金曲2：情歌王专辑里的歌	播放@singer唱的@album专辑里的歌
播放古巨基唱的当爱已成往事专辑里的歌	播放@singer唱的@album专辑里的歌
播放关喆唱的永远的永远专辑里的歌	播放@singer唱的@album专辑里的歌
播放郭静唱的在树上唱歌专辑里的歌	播放@singer唱的@album专辑里的歌
播放韩安旭唱的多幸运专辑里的歌	播放@singer唱的@album专辑里的歌
播放好妹妹乐队唱的不说再见专辑里的歌	播放@singer唱的@album专辑里的歌
播放胡歌唱的蓝光专辑里的歌	播放@singer唱的@album专辑里的歌
播放华晨宇唱的我的滑板鞋2016专辑里的歌	播放@singer唱的@album专辑里的歌
播放华晨宇唱的异类专辑里的歌	播放@singer唱的@album专辑里的歌
播放华晨宇和杨宗纬唱的异类专辑里的歌	播放@singer唱的@album专辑里的歌
播放黄丽玲唱的寂寞不痛专辑里的歌	播放@singer唱的@album专辑里的歌
播放黄小琥唱的简单/不简单专辑里的歌	播放@singer唱的@album专辑里的歌
播放黄雅莉唱的给眼泪一点时间专辑里的歌	播放@singer唱的@album专辑里的歌
播放回音哥唱的回音Echo专辑里的歌	播放@singer唱的@album专辑里的歌
播放贾斯汀·比伯唱的Sorry专辑里的歌	播放@singer唱的@album专辑里的歌
播放贾斯汀·比伯唱的Boyfriend专辑里的歌	播放@singer唱的@album专辑里的歌
播放降央卓玛唱的金色的呼唤专辑里的歌	播放@singer唱的@album专辑里的歌
播放金贵晟唱的I Believe爱不离专辑里的歌	播放@singer唱的@album专辑里的歌
播放凯蒂·佩里唱的Roar专辑里的歌	播放@singer唱的@album专辑里的歌
播放筷子兄弟唱的父亲专辑里的歌	播放@singer唱的@album专辑里的歌
播放赖伟锋唱的男朋女友专辑里的歌	播放@singer唱的@album专辑里的歌
播放老狼唱的校园名曲精选专辑里的歌	播放@singer唱的@album专辑里的歌
播放蕾哈娜唱的Diamonds专辑里的歌	播放@singer唱的@album专辑里的歌
播放李佳薇唱的感谢爱人专辑里的歌	播放@singer唱的@album专辑里的歌
播放李荣浩唱的李荣浩专辑里的歌	播放@singer唱的@album专辑里的歌
播放李荣浩唱的模特专辑里的歌	播放@singer唱的@album专辑里的歌
播放李宇春唱的Chris Lee 同名专辑专辑里的歌	播放@singer唱的@album专辑里的歌
播放李玉刚唱的新贵妃醉酒专辑里的歌	播放@singer唱的@album专辑里的歌
播放李玉刚唱的刚好遇见你专辑里的歌	播放@singer唱的@album专辑里的歌
播放李玉刚唱的天池南专辑里的歌	播放@singer唱的@album专辑里的歌
播放林俊杰唱的编号89757专辑里的歌	播放@singer唱的@album专辑里的歌
播放林俊杰唱的第二天堂专辑里的歌	播放@singer唱的@album专辑里的歌
播放林俊杰唱的因你而在专辑里的歌	播放@singer唱的@album专辑里的歌
播放林忆莲唱的林忆莲's专辑里的歌	播放@singer唱的@album专辑里的歌
播放刘辰希唱的思念是一把刀专辑里的歌	播放@singer唱的@album专辑里的歌
播放刘瑞琦唱的私房歌专辑里的歌	播放@singer唱的@album专辑里的歌
播放刘思涵唱的拥抱你专辑里的歌	播放@singer唱的@album专辑里的歌
播放刘惜君唱的因为遇见你 电视剧原声带专辑里的歌	播放@singer唱的@album专辑里的歌
播放鹿晗唱的勋章专辑里的歌	播放@singer唱的@album专辑里的歌
播放鹿晗唱的Xperience专辑里的歌	播放@singer唱的@album专辑里的歌
播放鹿晗唱的致爱 Your Song专辑里的歌	播放@singer唱的@album专辑里的歌
播放鹿先森乐队唱的所有的酒，都不如你专辑里的歌	播放@singer唱的@album专辑里的歌
播放梅根·特瑞娜唱的All About That Bass专辑里的歌	播放@singer唱的@album专辑里的歌
播放萌萌哒天团唱的帝都专辑里的歌	播放@singer唱的@album专辑里的歌
播放梦然唱的噢 爱人专辑里的歌	播放@singer唱的@album专辑里的歌
播放莫文蔚唱的如果没有你专辑里的歌	播放@singer唱的@album专辑里的歌
播放那英唱的有个爱你的人不容易专辑里的歌	播放@singer唱的@album专辑里的歌
播放南征北战唱的青春派 电影原声带专辑里的歌	播放@singer唱的@album专辑里的歌
播放南征北战唱的权力与荣耀专辑里的歌	播放@singer唱的@album专辑里的歌
播放彭佳慧唱的敲敲我的头专辑里的歌	播放@singer唱的@album专辑里的歌
播放鹏泊唱的啷个哩个啷专辑里的歌	播放@singer唱的@album专辑里的歌
播放齐晨唱的咱们结婚吧专辑里的歌	播放@singer唱的@album专辑里的歌
播放齐一唱的这个年纪专辑里的歌	播放@singer唱的@album专辑里的歌
播放青鸟飞鱼唱的仙剑奇侠传三 电视剧原声带专辑里的歌	播放@singer唱的@album专辑里的歌
播放上海彩虹室内合唱团唱的向天再要500话专辑里的歌	播放@singer唱的@album专辑里的歌
播放水木年华唱的一生有你专辑里的歌	播放@singer唱的@album专辑里的歌
播放宋冬野唱的安和桥北专辑里的歌	播放@singer唱的@album专辑里的歌
播放宋孟君和格子兮唱的王者荣耀专辑里的歌	播放@singer唱的@album专辑里的歌
播放苏打绿唱的秋：故事专辑里的歌	播放@singer唱的@album专辑里的歌
播放苏打绿唱的小宇宙专辑里的歌	播放@singer唱的@album专辑里的歌
播放孙燕姿唱的我要的幸福专辑里的歌	播放@singer唱的@album专辑里的歌
播放孙子涵唱的唐朝好男人 电视剧原声带专辑里的歌	播放@singer唱的@album专辑里的歌
播放谭维维唱的谭某某专辑里的歌	播放@singer唱的@album专辑里的歌
播放陶喆唱的太平盛世专辑里的歌	播放@singer唱的@album专辑里的歌
播放田馥甄和井柏然唱的美女与野兽专辑里的歌	播放@singer唱的@album专辑里的歌
播放万茜和音频怪物唱的为你成全专辑里的歌	播放@singer唱的@album专辑里的歌
播放汪峰唱的信仰在空中飘扬专辑里的歌	播放@singer唱的@album专辑里的歌
播放王菲唱的匆匆那年专辑里的歌	播放@singer唱的@album专辑里的歌
播放王力宏唱的十八般武艺专辑里的歌	播放@singer唱的@album专辑里的歌
播放王力宏唱的改变自己专辑里的歌	播放@singer唱的@album专辑里的歌
播放王力宏和卢巧音唱的力宏二十 20周年唯一精选专辑里的歌	播放@singer唱的@album专辑里的歌
播放王冕唱的空专辑里的歌	播放@singer唱的@album专辑里的歌
播放王若琳唱的Start From Here专辑里的歌	播放@singer唱的@album专辑里的歌
播放王童语唱的回了又去 去了再回专辑里的歌	播放@singer唱的@album专辑里的歌
播放韦礼安和郭静唱的风景旧曾谙专辑里的歌	播放@singer唱的@album专辑里的歌
播放吴克群唱的情人节专辑里的歌	播放@singer唱的@album专辑里的歌
播放吴亦凡唱的Bad Girl专辑里的歌	播放@singer唱的@album专辑里的歌
播放香香唱的三生三世十里桃花 电视剧原声带专辑里的歌	播放@singer唱的@album专辑里的歌
播放萧敬腾唱的王妃专辑里的歌	播放@singer唱的@album专辑里的歌
播放萧敬腾唱的狂想曲专辑里的歌	播放@singer唱的@album专辑里的歌
播放萧亚轩唱的萧亚轩 同名专辑专辑里的歌	播放@singer唱的@album专辑里的歌
播放萧亚轩唱的三面夏娃专辑里的歌	播放@singer唱的@album专辑里的歌
播放徐誉滕唱的茉莉花开专辑里的歌	播放@singer唱的@album专辑里的歌
播放许茹芸唱的如果云知道专辑里的歌	播放@singer唱的@album专辑里的歌
播放许嵩唱的自定义专辑里的歌	播放@singer唱的@album专辑里的歌
播放许嵩唱的Vae新歌 精选珍藏合辑专辑里的歌	播放@singer唱的@album专辑里的歌
播放许嵩和何曼婷唱的素颜专辑里的歌	播放@singer唱的@album专辑里的歌
播放许巍唱的时光·漫步专辑里的歌	播放@singer唱的@album专辑里的歌
播放薛之谦唱的绅士专辑里的歌	播放@singer唱的@album专辑里的歌
播放薛之谦唱的初学者专辑里的歌	播放@singer唱的@album专辑里的歌
播放杨坤唱的杨坤 同名专辑专辑里的歌	播放@singer唱的@album专辑里的歌
播放杨宗纬唱的初.爱专辑里的歌	播放@singer唱的@album专辑里的歌
播放杨宗纬和张碧晨唱的凉凉专辑里的歌	播放@singer唱的@album专辑里的歌
播放易烊千玺唱的你说专辑里的歌	播放@singer唱的@album专辑里的歌
播放郁可唯唱的三生三世十里桃花 电视剧原声带专辑里的歌	播放@singer唱的@album专辑里的歌
播放郁可唯唱的夙念专辑里的歌	播放@singer唱的@album专辑里的歌
播放郁可唯和张哲瀚唱的天下无敌专辑里的歌	播放@singer唱的@album专辑里的歌
播放张碧晨唱的曾经守候专辑里的歌	播放@singer唱的@album专辑里的歌
播放张碧晨唱的It's Love专辑里的歌	播放@singer唱的@album专辑里的歌
播放张杰唱的三生三世专辑里的歌	播放@singer唱的@album专辑里的歌
播放张杰唱的明天过后专辑里的歌	播放@singer唱的@album专辑里的歌
播放张杰唱的爱，不解释专辑里的歌	播放@singer唱的@album专辑里的歌
播放张敬轩唱的Urban Emotions专辑里的歌	播放@singer唱的@album专辑里的歌
播放张靓颖唱的我的梦专辑里的歌	播放@singer唱的@album专辑里的歌
播放张靓颖唱的思美人专辑里的歌	播放@singer唱的@album专辑里的歌
播放张韶涵唱的潘朵拉专辑里的歌	播放@singer唱的@album专辑里的歌
播放张信哲唱的夏夜星空海专辑里的歌	播放@singer唱的@album专辑里的歌
播放张学友唱的忘记你我做不到专辑里的歌	播放@singer唱的@album专辑里的歌
播放张学友唱的真爱专辑里的歌	播放@singer唱的@album专辑里的歌
播放张学友唱的我与你专辑里的歌	播放@singer唱的@album专辑里的歌
播放张学友唱的学友 热专辑里的歌	播放@singer唱的@album专辑里的歌
播放张宇唱的消息专辑里的歌	播放@singer唱的@album专辑里的歌
播放张宇唱的雨一直下专辑里的歌	播放@singer唱的@album专辑里的歌
播放张芸京唱的破天荒专辑里的歌	播放@singer唱的@album专辑里的歌
播放赵雷唱的赵小雷专辑里的歌	播放@singer唱的@album专辑里的歌
播放赵雷唱的吉姆餐厅专辑里的歌	播放@singer唱的@album专辑里的歌
播放郑智化唱的私房歌专辑里的歌	播放@singer唱的@album专辑里的歌
播放周柏豪和卫兰唱的近在千里专辑里的歌	播放@singer唱的@album专辑里的歌
播放周传雄唱的忘记专辑里的歌	播放@singer唱的@album专辑里的歌
播放周蕙唱的周蕙精选专辑里的歌	播放@singer唱的@album专辑里的歌
播放周杰伦唱的魔杰座专辑里的歌	播放@singer唱的@album专辑里的歌
播放周杰伦唱的周杰伦的床边故事专辑里的歌	播放@singer唱的@album专辑里的歌
播放周杰伦唱的哎呦，不错哦专辑里的歌	播放@singer唱的@album专辑里的歌
播放周杰伦唱的我很忙专辑里的歌	播放@singer唱的@album专辑里的歌
播放周杰伦唱的叶惠美专辑里的歌	播放@singer唱的@album专辑里的歌
播放周深唱的回声专辑里的歌	播放@singer唱的@album专辑里的歌
播放庄心妍唱的走着走着就散了专辑里的歌	播放@singer唱的@album专辑里的歌
播放庄心妍唱的Touch Of Love专辑里的歌	播放@singer唱的@album专辑里的歌
播放庄心妍唱的一万个舍不得专辑里的歌	播放@singer唱的@album专辑里的歌
播放庄心妍和祁隆唱的一万个舍不得专辑里的歌	播放@singer唱的@album专辑里的歌
播放陈冰和夏恒唱的爱，来的刚好专辑里的歌	播放@singer唱的@album专辑里的歌
播放谢春花唱的知非专辑里的歌	播放@singer唱的@album专辑里的歌
播放Coldplay唱的Hypnotised专辑里的歌	播放@singer唱的@album专辑里的歌
播放Lana Del Rey唱的Love专辑里的歌	播放@singer唱的@album专辑里的歌
播放Calvin Harris和Frank Ocean唱的Slide专辑里的歌	播放@singer唱的@album专辑里的歌
播放张希和曹方唱的认真的老去专辑里的歌	播放@singer唱的@album专辑里的歌
播放范玮琪唱的在幸福的路上专辑里的歌	播放@singer唱的@album专辑里的歌
播放Meghan Trainor唱的I'm a Lady专辑里的歌	播放@singer唱的@album专辑里的歌
播放林宥嘉唱的让世界毁灭专辑里的歌	播放@singer唱的@album专辑里的歌
播放简弘亦唱的伤心花专辑里的歌	播放@singer唱的@album专辑里的歌
播放郭美美唱的我会一直想你专辑里的歌	播放@singer唱的@album专辑里的歌
播放双笙唱的终身误专辑里的歌	播放@singer唱的@album专辑里的歌
播放Dough-Boy和侧田唱的天空之城专辑里的歌	播放@singer唱的@album专辑里的歌
播放霍尊唱的大唐荣耀 电视剧原声带专辑里的歌	播放@singer唱的@album专辑里的歌
播放Sia唱的Fifty Shades Darker专辑里的歌	播放@singer唱的@album专辑里的歌
播放林俊熙和王晋桢唱的刚好遇见你专辑里的歌	播放@singer唱的@album专辑里的歌
播放陈鸿宇唱的额尔古纳专辑里的歌	播放@singer唱的@album专辑里的歌
播放Zedd和Alessia Cara唱的Stay专辑里的歌	播放@singer唱的@album专辑里的歌
播放孙露唱的痛快人生专辑里的歌	播放@singer唱的@album专辑里的歌
播放San Holo唱的Light专辑里的歌	播放@singer唱的@album专辑里的歌
播放华语群星唱的三生三世十里桃花 电视剧配乐专辑里的歌	播放@singer唱的@album专辑里的歌
播放BY2唱的爱又爱专辑里的歌	播放@singer唱的@album专辑里的歌
播放陈鸿宇唱的一如年少模样专辑里的歌	播放@singer唱的@album专辑里的歌
播放李宏毅和李明霖唱的恶魔的爱专辑里的歌	播放@singer唱的@album专辑里的歌
播放Lorde唱的Green Light专辑里的歌	播放@singer唱的@album专辑里的歌
播放马博唱的菊花爆满山专辑里的歌	播放@singer唱的@album专辑里的歌
播放蔡佳淳的歌	播放@singer的歌
播放蔡雅健的歌	播放@singer的歌
播放曹月的歌	播放@singer的歌
播放草猛的歌	播放@singer的歌
播放册田的歌	播放@singer的歌
播放曾沛辞的歌	播放@singer的歌
播放曾亿可的歌	播放@singer的歌
播放陈慧林的歌	播放@singer的歌
播放陈伟庭的歌	播放@singer的歌
播放范小萱的歌	播放@singer的歌
播放后玄的歌	播放@singer的歌
播放胡彦彬的歌	播放@singer的歌
播放华辰宇的歌	播放@singer的歌
播放黄小虎的歌	播放@singer的歌
播放吉克隽益的歌	播放@singer的歌
播放姜育衡的歌	播放@singer的歌
播放金海馨的歌	播放@singer的歌
播放井博然的歌	播放@singer的歌
播放九月奇迹的歌	播放@singer的歌
播放李戴莫的歌	播放@singer的歌
播放李荣昊的歌	播放@singer的歌
播放李小路的歌	播放@singer的歌
播放李一峰的歌	播放@singer的歌
播放梁静如的歌	播放@singer的歌
播放梁咏其的歌	播放@singer的歌
播放林俊洁的歌	播放@singer的歌
播放林忆连的歌	播放@singer的歌
播放林宥佳的歌	播放@singer的歌
播放刘德桦的歌	播放@singer的歌
播放陆晗的歌	播放@singer的歌
播放罗大右的歌	播放@singer的歌
播放潘伟柏的歌	播放@singer的歌
播放戚微的歌	播放@singer的歌
播放齐覃的歌	播放@singer的歌
播放乔任凉的歌	播放@singer的歌
播放曲宛婷的歌	播放@singer的歌
播放沙宝晾的歌	播放@singer的歌
播放苏大绿的歌	播放@singer的歌
播放王俊恺的歌	播放@singer的歌
播放王峥亮的歌	播放@singer的歌
播放王组蓝的歌	播放@singer的歌
播放谢那的歌	播放@singer的歌
播放杨宗伟的歌	播放@singer的歌
播放易阳千玺的歌	播放@singer的歌
播放岳云彭的歌	播放@singer的歌
播放张靓影的歌	播放@singer的歌
播放周洁伦的歌	播放@singer的歌
播放国民美少女团员的歌	播放@singer_combination的歌
播放SNH48的歌	播放@singer_combination的歌
播放小蓓蕾组合的歌	播放@singer_combination的歌
播放伍佰 & China Blue的歌	播放@singer_combination的歌
播放S.I.N.G 女团的歌	播放@singer_combination的歌
播放鹿先森乐队的歌	播放@singer_combination的歌
播放七朵组合的歌	播放@singer_combination的歌
播放晨悠组合的歌	播放@singer_combination的歌
播放SpeXial的歌	播放@singer_combination的歌
播放茉茉天空的歌	播放@singer_combination的歌
播放F4的歌	播放@singer_combination的歌
播放青鸟飞鱼的歌	播放@singer_combination的歌
播放花儿乐队的歌	播放@singer_combination的歌
播放Sweety的歌	播放@singer_combination的歌
播放TimeZ的歌	播放@singer_combination的歌
播放1022女声的歌	播放@singer_combination的歌
播放海龟先生的歌	播放@singer_combination的歌
播放零点乐队的歌	播放@singer_combination的歌
播放黑豹乐队的歌	播放@singer_combination的歌
播放吉佑社的歌	播放@singer_combination的歌
播放TF家族的歌	播放@singer_combination的歌
播放大庆小芳的歌	播放@singer_combination的歌
播放丢火车乐队的歌	播放@singer_combination的歌
播放自然卷的歌	播放@singer_combination的歌
播放Dance Flow的歌	播放@singer_combination的歌
播放BOBO的歌	播放@singer_combination的歌
播放MIC男团的歌	播放@singer_combination的歌
播放火星电台的歌	播放@singer_combination的歌
播放白银河的歌	播放@singer_combination的歌
播放痛仰乐队的歌	播放@singer_combination的歌
播放部落组合的歌	播放@singer_combination的歌
播放旅行团的歌	播放@singer_combination的歌
播放大嘴巴的歌	播放@singer_combination的歌
播放UNIQ的歌	播放@singer_combination的歌
播放飞轮海的歌	播放@singer_combination的歌
播放房东的猫的歌	播放@singer_combination的歌
播放耿直男儿的歌	播放@singer_combination的歌
播放东城卫的歌	播放@singer_combination的歌
播放C-block的歌	播放@singer_combination的歌
播放蜜雪薇琪的歌	播放@singer_combination的歌
播放安与骑兵的歌	播放@singer_combination的歌
播放夏天播放的歌	播放@singer_combination的歌
播放动力火车的歌	播放@singer_combination的歌
播放爱乐团的歌	播放@singer_combination的歌
播放旭日阳刚的歌	播放@singer_combination的歌
播放橙光音乐的歌	播放@singer_combination的歌
播放棒棒堂的歌	播放@singer_combination的歌
播放Mr.的歌	播放@singer_combination的歌
播放纵贯线的歌	播放@singer_combination的歌
播放Super Junior-M的歌	播放@singer_combination的歌
播放打扰一下乐团的歌	播放@singer_combination的歌
播放墨明棋妙的歌	播放@singer_combination的歌
播放Robynn & Kendy的歌	播放@singer_combination的歌
播放5566的歌	播放@singer_combination的歌
播放神木与瞳的歌	播放@singer_combination的歌
播放JS的歌	播放@singer_combination的歌
播放中央人民广播电台少年广播合唱团的歌	播放@singer_combination的歌
播放SWIN-S的歌	播放@singer_combination的歌
播放满汉全席音乐团队的歌	播放@singer_combination的歌
播放自由派对的歌	播放@singer_combination的歌
播放天炫男孩的歌	播放@singer_combination的歌
播放可米小子的歌	播放@singer_combination的歌
播放优客李林的歌	播放@singer_combination的歌
播放大乔小乔的歌	播放@singer_combination的歌
播放传奇乐坊的歌	播放@singer_combination的歌
播放S翼乐团的歌	播放@singer_combination的歌
播放SHE的歌	播放@singer_combination的歌
播放经典英语歌	播放@theme@language歌
播放经典纯音乐	播放@theme@language歌
播放经典西班牙语歌	播放@theme@language歌
播放经典德语歌	播放@theme@language歌
播放经典国语歌	播放@theme@language歌
播放经典日语歌	播放@theme@language歌
播放经典法语歌	播放@theme@language歌
播放经典意大利语歌	播放@theme@language歌
播放经典葡萄牙语歌	播放@theme@language歌
播放经典韩语歌	播放@theme@language歌
播放经典印度语歌	播放@theme@language歌
播放经典俄语歌	播放@theme@language歌
播放经典粤语歌	播放@theme@language歌
播放经典瑞典语歌	播放@theme@language歌
播放经典闽南语歌	播放@theme@language歌
播放经典印尼语歌	播放@theme@language歌
播放经典菲律宾语歌	播放@theme@language歌
播放经典拉丁语歌	播放@theme@language歌
播放经典小语种歌	播放@theme@language歌
播放经典泰语歌	播放@theme@language歌
播放ACG英语歌	播放@theme@language歌
播放ACG纯音乐	播放@theme@language歌
播放ACG西班牙语歌	播放@theme@language歌
播放ACG德语歌	播放@theme@language歌
播放ACG国语歌	播放@theme@language歌
播放ACG日语歌	播放@theme@language歌
播放ACG法语歌	播放@theme@language歌
播放ACG意大利语歌	播放@theme@language歌
播放ACG葡萄牙语歌	播放@theme@language歌
播放ACG韩语歌	播放@theme@language歌
播放ACG印度语歌	播放@theme@language歌
播放ACG俄语歌	播放@theme@language歌
播放ACG粤语歌	播放@theme@language歌
播放ACG瑞典语歌	播放@theme@language歌
播放ACG闽南语歌	播放@theme@language歌
播放ACG印尼语歌	播放@theme@language歌
播放ACG菲律宾语歌	播放@theme@language歌
播放ACG拉丁语歌	播放@theme@language歌
播放ACG小语种歌	播放@theme@language歌
播放ACG泰语歌	播放@theme@language歌
播放影视英语歌	播放@theme@language歌
播放影视纯音乐	播放@theme@language歌
播放影视西班牙语歌	播放@theme@language歌
播放影视德语歌	播放@theme@language歌
播放影视国语歌	播放@theme@language歌
播放影视日语歌	播放@theme@language歌
播放影视法语歌	播放@theme@language歌
播放影视意大利语歌	播放@theme@language歌
播放影视葡萄牙语歌	播放@theme@language歌
播放影视韩语歌	播放@theme@language歌
播放影视印度语歌	播放@theme@language歌
播放影视俄语歌	播放@theme@language歌
播放影视粤语歌	播放@theme@language歌
播放影视瑞典语歌	播放@theme@language歌
播放影视闽南语歌	播放@theme@language歌
播放影视印尼语歌	播放@theme@language歌
播放影视菲律宾语歌	播放@theme@language歌
播放影视拉丁语歌	播放@theme@language歌
播放影视小语种歌	播放@theme@language歌
播放影视泰语歌	播放@theme@language歌
播放可以作为背景音乐的英语歌	播放@theme@language歌
播放作为背景音乐的纯音乐	播放@theme@language歌
播放作为背景音乐的西班牙语歌	播放@theme@language歌
播放作为背景音乐的德语歌	播放@theme@language歌
播放作为背景音乐的国语歌	播放@theme@language歌
播放作为背景音乐的日语歌	播放@theme@language歌
播放作为背景音乐的法语歌	播放@theme@language歌
播放作为背景音乐的意大利语歌	播放@theme@language歌
播放作为背景音乐的葡萄牙语歌	播放@theme@language歌
播放作为背景音乐的韩语歌	播放@theme@language歌
播放作为背景音乐的印度语歌	播放@theme@language歌
播放作为背景音乐的俄语歌	播放@theme@language歌
播放作为背景音乐的粤语歌	播放@theme@language歌
播放作为背景音乐的瑞典语歌	播放@theme@language歌
播放作为背景音乐的闽南语歌	播放@theme@language歌
播放作为背景音乐的印尼语歌	播放@theme@language歌
播放作为背景音乐的菲律宾语歌	播放@theme@language歌
播放作为背景音乐的拉丁语歌	播放@theme@language歌
播放作为背景音乐的小语种歌	播放@theme@language歌
播放作为背景音乐的泰语歌	播放@theme@language歌
播放网络歌曲里的英语歌	播放@theme@language歌
播放网络歌曲里的纯音乐	播放@theme@language歌
播放网络歌曲里的西班牙语歌	播放@theme@language歌
播放网络歌曲里的德语歌	播放@theme@language歌
播放网络歌曲里的国语歌	播放@theme@language歌
播放网络歌曲里的日语歌	播放@theme@language歌
播放网络歌曲里的法语歌	播放@theme@language歌
播放网络歌曲里的意大利语歌	播放@theme@language歌
播放网络歌曲里的葡萄牙语歌	播放@theme@language歌
播放网络歌曲里的韩语歌	播放@theme@language歌
播放网络歌曲里的印度语歌	播放@theme@language歌
播放网络歌曲里的俄语歌	播放@theme@language歌
播放网络歌曲里的粤语歌	播放@theme@language歌
播放网络歌曲里的瑞典语歌	播放@theme@language歌
播放网络歌曲里的闽南语歌	播放@theme@language歌
播放网络歌曲里的印尼语歌	播放@theme@language歌
播放网络歌曲里的菲律宾语歌	播放@theme@language歌
播放网络歌曲里的拉丁语歌	播放@theme@language歌
播放网络歌曲里的小语种歌	播放@theme@language歌
播放网络歌曲里的泰语歌	播放@theme@language歌
播放DJ英语歌	播放@theme@language歌
播放DJ纯音乐	播放@theme@language歌
播放DJ西班牙语歌	播放@theme@language歌
播放DJ德语歌	播放@theme@language歌
播放DJ国语歌	播放@theme@language歌
播放DJ日语歌	播放@theme@language歌
播放DJ法语歌	播放@theme@language歌
播放DJ意大利语歌	播放@theme@language歌
播放DJ葡萄牙语歌	播放@theme@language歌
播放DJ韩语歌	播放@theme@language歌
播放DJ印度语歌	播放@theme@language歌
播放DJ俄语歌	播放@theme@language歌
播放DJ粤语歌	播放@theme@language歌
播放DJ瑞典语歌	播放@theme@language歌
播放DJ闽南语歌	播放@theme@language歌
播放DJ印尼语歌	播放@theme@language歌
播放DJ菲律宾语歌	播放@theme@language歌
播放DJ拉丁语歌	播放@theme@language歌
播放DJ小语种歌	播放@theme@language歌
播放DJ泰语歌	播放@theme@language歌
播放KTV热歌中的英语歌	播放@theme@language歌
播放KTV热歌中的纯音乐	播放@theme@language歌
播放KTV热歌中的西班牙语歌	播放@theme@language歌
播放KTV热歌中的德语歌	播放@theme@language歌
播放KTV热歌中的国语歌	播放@theme@language歌
播放KTV热歌中的日语歌	播放@theme@language歌
播放KTV热歌中的法语歌	播放@theme@language歌
播放KTV热歌中的意大利语歌	播放@theme@language歌
播放KTV热歌中的葡萄牙语歌	播放@theme@language歌
播放KTV热歌中的韩语歌	播放@theme@language歌
播放KTV热歌中的印度语歌	播放@theme@language歌
播放KTV热歌中的俄语歌	播放@theme@language歌
播放KTV热歌中的粤语歌	播放@theme@language歌
播放KTV热歌中的瑞典语歌	播放@theme@language歌
播放KTV热歌中的闽南语歌	播放@theme@language歌
播放KTV热歌中的印尼语歌	播放@theme@language歌
播放KTV热歌中的菲律宾语歌	播放@theme@language歌
播放KTV热歌中的拉丁语歌	播放@theme@language歌
播放KTV热歌中的小语种歌	播放@theme@language歌
播放KTV热歌中的泰语歌	播放@theme@language歌
播放具有中国风的英语歌	播放@theme@language歌
播放具有中国风的纯音乐	播放@theme@language歌
播放具有中国风的西班牙语歌	播放@theme@language歌
播放具有中国风的德语歌	播放@theme@language歌
播放具有中国风的国语歌	播放@theme@language歌
播放具有中国风的日语歌	播放@theme@language歌
播放具有中国风的法语歌	播放@theme@language歌
播放具有中国风的意大利语歌	播放@theme@language歌
播放具有中国风的葡萄牙语歌	播放@theme@language歌
播放具有中国风的韩语歌	播放@theme@language歌
播放具有中国风的印度语歌	播放@theme@language歌
播放具有中国风的俄语歌	播放@theme@language歌
播放具有中国风的粤语歌	播放@theme@language歌
播放具有中国风的瑞典语歌	播放@theme@language歌
播放具有中国风的闽南语歌	播放@theme@language歌
播放具有中国风的印尼语歌	播放@theme@language歌
播放具有中国风的菲律宾语歌	播放@theme@language歌
播放具有中国风的拉丁语歌	播放@theme@language歌
播放具有中国风的小语种歌	播放@theme@language歌
播放具有中国风的泰语歌	播放@theme@language歌
播放情歌英语歌	播放@theme@language歌
播放情歌纯音乐	播放@theme@language歌
播放情歌西班牙语歌	播放@theme@language歌
播放情歌德语歌	播放@theme@language歌
播放情歌国语歌	播放@theme@language歌
播放情歌日语歌	播放@theme@language歌
播放情歌法语歌	播放@theme@language歌
播放情歌意大利语歌	播放@theme@language歌
播放情歌葡萄牙语歌	播放@theme@language歌
播放情歌韩语歌	播放@theme@language歌
播放情歌印度语歌	播放@theme@language歌
播放情歌俄语歌	播放@theme@language歌
播放情歌粤语歌	播放@theme@language歌
播放情歌瑞典语歌	播放@theme@language歌
播放情歌闽南语歌	播放@theme@language歌
播放情歌印尼语歌	播放@theme@language歌
播放情歌菲律宾语歌	播放@theme@language歌
播放情歌拉丁语歌	播放@theme@language歌
播放情歌小语种歌	播放@theme@language歌
播放情歌泰语歌	播放@theme@language歌
播放现场音乐英语歌	播放@theme@language歌
播放现场音乐纯音乐	播放@theme@language歌
播放现场音乐西班牙语歌	播放@theme@language歌
播放现场音乐德语歌	播放@theme@language歌
播放现场音乐国语歌	播放@theme@language歌
播放现场音乐日语歌	播放@theme@language歌
播放现场音乐法语歌	播放@theme@language歌
播放现场音乐意大利语歌	播放@theme@language歌
播放现场音乐葡萄牙语歌	播放@theme@language歌
播放现场音乐韩语歌	播放@theme@language歌
播放现场音乐印度语歌	播放@theme@language歌
播放现场音乐俄语歌	播放@theme@language歌
播放现场音乐粤语歌	播放@theme@language歌
播放现场音乐瑞典语歌	播放@theme@language歌
播放现场音乐闽南语歌	播放@theme@language歌
播放现场音乐印尼语歌	播放@theme@language歌
播放现场音乐菲律宾语歌	播放@theme@language歌
播放现场音乐拉丁语歌	播放@theme@language歌
播放现场音乐小语种歌	播放@theme@language歌
播放现场音乐泰语歌	播放@theme@language歌
播放城市英语歌	播放@theme@language歌
播放城市纯音乐	播放@theme@language歌
播放城市西班牙语歌	播放@theme@language歌
播放城市德语歌	播放@theme@language歌
播放城市国语歌	播放@theme@language歌
播放城市日语歌	播放@theme@language歌
播放城市法语歌	播放@theme@language歌
播放城市意大利语歌	播放@theme@language歌
播放城市葡萄牙语歌	播放@theme@language歌
播放城市韩语歌	播放@theme@language歌
播放城市印度语歌	播放@theme@language歌
播放城市俄语歌	播放@theme@language歌
播放城市粤语歌	播放@theme@language歌
播放城市瑞典语歌	播放@theme@language歌
播放城市闽南语歌	播放@theme@language歌
播放城市印尼语歌	播放@theme@language歌
播放城市菲律宾语歌	播放@theme@language歌
播放城市拉丁语歌	播放@theme@language歌
播放城市小语种歌	播放@theme@language歌
播放城市泰语歌	播放@theme@language歌
播放UP主里的英语歌	播放@theme@language歌
播放UP主里的纯音乐	播放@theme@language歌
播放UP主里的西班牙语歌	播放@theme@language歌
播放UP主里的德语歌	播放@theme@language歌
播放UP主里的国语歌	播放@theme@language歌
播放UP主里的日语歌	播放@theme@language歌
播放UP主里的法语歌	播放@theme@language歌
播放UP主里的意大利语歌	播放@theme@language歌
播放UP主里的葡萄牙语歌	播放@theme@language歌
播放UP主里的韩语歌	播放@theme@language歌
播放UP主里的印度语歌	播放@theme@language歌
播放UP主里的俄语歌	播放@theme@language歌
播放UP主里的粤语歌	播放@theme@language歌
播放UP主里的瑞典语歌	播放@theme@language歌
播放UP主里的闽南语歌	播放@theme@language歌
播放UP主里的印尼语歌	播放@theme@language歌
播放UP主里的菲律宾语歌	播放@theme@language歌
播放UP主里的拉丁语歌	播放@theme@language歌
播放UP主里的小语种歌	播放@theme@language歌
播放UP主里的泰语歌	播放@theme@language歌
播放儿歌英语歌	播放@theme@language歌
播放儿歌纯音乐	播放@theme@language歌
播放儿歌西班牙语歌	播放@theme@language歌
播放儿歌德语歌	播放@theme@language歌
播放儿歌国语歌	播放@theme@language歌
播放儿歌日语歌	播放@theme@language歌
播放儿歌法语歌	播放@theme@language歌
播放儿歌意大利语歌	播放@theme@language歌
播放儿歌葡萄牙语歌	播放@theme@language歌
播放儿歌韩语歌	播放@theme@language歌
播放儿歌印度语歌	播放@theme@language歌
播放儿歌俄语歌	播放@theme@language歌
播放儿歌粤语歌	播放@theme@language歌
播放儿歌瑞典语歌	播放@theme@language歌
播放儿歌闽南语歌	播放@theme@language歌
播放儿歌印尼语歌	播放@theme@language歌
播放儿歌菲律宾语歌	播放@theme@language歌
播放儿歌拉丁语歌	播放@theme@language歌
播放儿歌小语种歌	播放@theme@language歌
播放儿歌泰语歌	播放@theme@language歌
播放佛教音乐里的英语歌	播放@theme@language歌
播放佛教音乐里的纯音乐	播放@theme@language歌
播放佛教音乐里的西班牙语歌	播放@theme@language歌
播放佛教音乐里的德语歌	播放@theme@language歌
播放佛教音乐里的国语歌	播放@theme@language歌
播放佛教音乐里的日语歌	播放@theme@language歌
播放佛教音乐里的法语歌	播放@theme@language歌
播放佛教音乐里的意大利语歌	播放@theme@language歌
播放佛教音乐里的葡萄牙语歌	播放@theme@language歌
播放佛教音乐里的韩语歌	播放@theme@language歌
播放佛教音乐里的印度语歌	播放@theme@language歌
播放佛教音乐里的俄语歌	播放@theme@language歌
播放佛教音乐里的粤语歌	播放@theme@language歌
播放佛教音乐里的瑞典语歌	播放@theme@language歌
播放佛教音乐里的闽南语歌	播放@theme@language歌
播放佛教音乐里的印尼语歌	播放@theme@language歌
播放佛教音乐里的菲律宾语歌	播放@theme@language歌
播放佛教音乐里的拉丁语歌	播放@theme@language歌
播放佛教音乐里的小语种歌	播放@theme@language歌
播放佛教音乐里的泰语歌	播放@theme@language歌
播放古风英语歌	播放@theme@language歌
播放古风纯音乐	播放@theme@language歌
播放古风西班牙语歌	播放@theme@language歌
播放古风德语歌	播放@theme@language歌
播放古风国语歌	播放@theme@language歌
播放古风日语歌	播放@theme@language歌
播放古风法语歌	播放@theme@language歌
播放古风意大利语歌	播放@theme@language歌
播放古风葡萄牙语歌	播放@theme@language歌
播放古风韩语歌	播放@theme@language歌
播放古风印度语歌	播放@theme@language歌
播放古风俄语歌	播放@theme@language歌
播放古风粤语歌	播放@theme@language歌
播放古风瑞典语歌	播放@theme@language歌
播放古风闽南语歌	播放@theme@language歌
播放古风印尼语歌	播放@theme@language歌
播放古风菲律宾语歌	播放@theme@language歌
播放古风拉丁语歌	播放@theme@language歌
播放古风小语种歌	播放@theme@language歌
播放古风泰语歌	播放@theme@language歌
播放﻿阿沁和陈曼青唱的歌	播放@singer1和@singer2唱的歌
播放成龙和MIC男团唱的歌	播放@singer1和@singer2唱的歌
播放韩寒和亭东小伙伴唱的歌	播放@singer1和@singer2唱的歌
播放华晨宇和杨宗纬唱的歌	播放@singer1和@singer2唱的歌
播放贾乃亮和贾云馨唱的歌	播放@singer1和@singer2唱的歌
播放李玟和林俊杰唱的歌	播放@singer1和@singer2唱的歌
播放李溪芮和张彬彬唱的歌	播放@singer1和@singer2唱的歌
播放梁朝伟和李宇春唱的歌	播放@singer1和@singer2唱的歌
播放潘玮柏和关晓彤唱的歌	播放@singer1和@singer2唱的歌
播放宋孟君和格子兮唱的歌	播放@singer1和@singer2唱的歌
播放谭晶和吴亦凡唱的歌	播放@singer1和@singer2唱的歌
播放田馥甄和井柏然唱的歌	播放@singer1和@singer2唱的歌
播放万茜和音频怪物唱的歌	播放@singer1和@singer2唱的歌
播放王力宏和卢巧音唱的歌	播放@singer1和@singer2唱的歌
播放韦礼安和郭静唱的歌	播放@singer1和@singer2唱的歌
播放徐子洋和杨浩宇唱的歌	播放@singer1和@singer2唱的歌
播放许嵩和何曼婷唱的歌	播放@singer1和@singer2唱的歌
播放杨坤和华晨宇唱的歌	播放@singer1和@singer2唱的歌
播放杨宗纬和张碧晨唱的歌	播放@singer1和@singer2唱的歌
播放姚晨和林更新唱的歌	播放@singer1和@singer2唱的歌
播放郁可唯和张哲瀚唱的歌	播放@singer1和@singer2唱的歌
播放岳云鹏和好妹妹乐队唱的歌	播放@singer1和@singer2唱的歌
播放张靓颖和万家铭唱的歌	播放@singer1和@singer2唱的歌
播放周柏豪和Shimica唱的歌	播放@singer1和@singer2唱的歌
播放周柏豪和岑宁儿唱的歌	播放@singer1和@singer2唱的歌
播放庄心妍和祁隆唱的歌	播放@singer1和@singer2唱的歌
播放周杰伦和费玉清唱的歌	播放@singer1和@singer2唱的歌
播放宋祖英和周杰伦唱的歌	播放@singer1和@singer2唱的歌
播放周杰伦和袁咏琳唱的歌	播放@singer1和@singer2唱的歌
播放周杰伦和梁心颐唱的歌	播放@singer1和@singer2唱的歌
播放林俊杰和蔡卓妍唱的歌	播放@singer1和@singer2唱的歌
播放林俊杰和五月天唱的歌	播放@singer1和@singer2唱的歌
播放金莎和林俊杰唱的歌	播放@singer1和@singer2唱的歌
播放林俊杰和林志颖唱的歌	播放@singer1和@singer2唱的歌
播放飞轮海和田馥甄唱的歌	播放@singer1和@singer2唱的歌
播放林宥嘉和郁可唯唱的歌	播放@singer1和@singer2唱的歌
播放张杰和林宥嘉唱的歌	播放@singer1和@singer2唱的歌
播放阿肆和林宥嘉唱的歌	播放@singer1和@singer2唱的歌
播放曾沛慈和林宥嘉唱的歌	播放@singer1和@singer2唱的歌
播放张靓颖和张杰唱的歌	播放@singer1和@singer2唱的歌
播放张杰和莫文蔚唱的歌	播放@singer1和@singer2唱的歌
播放张靓颖和韩庚唱的歌	播放@singer1和@singer2唱的歌
播放韩庚和萧亚轩唱的歌	播放@singer1和@singer2唱的歌
播放王菲和那英唱的歌	播放@singer1和@singer2唱的歌
播放何炅和严艺丹唱的歌	播放@singer1和@singer2唱的歌
播放井柏然和白百合唱的歌	播放@singer1和@singer2唱的歌
播放井柏然和郑爽唱的歌	播放@singer1和@singer2唱的歌
播放付辛博和井柏然唱的歌	播放@singer1和@singer2唱的歌
播放Alan Walker和Iselin Solheim唱的歌	播放@singer1和@singer2唱的歌
播放Ariana Grande和John Legend唱的歌	播放@singer1和@singer2唱的歌
播放Calvin Harris和Rihanna唱的歌	播放@singer1和@singer2唱的歌
播放Charlie Puth和Selena Gomez唱的歌	播放@singer1和@singer2唱的歌
播放Fifth Harmony和KiD Ink唱的歌	播放@singer1和@singer2唱的歌
播放大陆女歌手的歌	播放@singer_attribute歌手的歌
播放中国女歌手的歌	播放@singer_attribute歌手的歌
播放欧美女歌手的歌	播放@singer_attribute歌手的歌
播放港台女歌手的歌	播放@singer_attribute歌手的歌
播放日韩女歌手的歌	播放@singer_attribute歌手的歌
播放大陆男歌手的歌	播放@singer_attribute歌手的歌
播放中国男歌手的歌	播放@singer_attribute歌手的歌
播放欧美男歌手的歌	播放@singer_attribute歌手的歌
播放港台男歌手的歌	播放@singer_attribute歌手的歌
播放日韩男歌手的歌	播放@singer_attribute歌手的歌
唱匆匆那年	不要@singer的
唱周杰伦的歌	不要@singer的
播放李荣浩唱的李荣浩专辑里的歌
唱郁可唯的国语国歌思慕	唱@singer的@language歌曲@song
播放回音哥唱的经典的流行歌曲	播放@singer唱的@theme的@style歌曲
播放睡前安静的民谣	播放@scene@emotion的@style
播放1121专辑的歌	播放@album专辑的歌
播放25专辑的歌	播放@album专辑的歌
